ethel_lilian_voynich	parents	george_boole
georg_donner	place_of_death	vienna
tadamichi_kuribayashi	location	nagano_prefecture
richmond_pearson_hobson	place_of_birth	greensboro_alabama
hugo_vivian_hope_throssell	place_of_birth	northam
alphonse_halimi	religion	judaism
f_a_voigt	place_of_birth	hampstead
suleiman_mousa	nationality	jordan
marlon_brando	location	omaha_nebraska
john_j_williams	profession	businessperson
franz_xaver_wolfgang_mozart	parents	constanze_mozart
bernard_bresslaw	nationality	england
leone_battista_alberti	profession	architect
frederick_william_cumberland	profession	architect
ludvig_holberg	place_of_death	copenhagen
sherwood_anderson	profession	novelist
taoyateduta	cause_of_death	murder
hermann_van_pels	location	lower_saxony
nero_claudius_drusus	gender	male
joseph_strick	cause_of_death	congestive_heart_failure
james_hepburn	gender	male
andre_kertesz	location	paris
thomas_innes_of_learney	nationality	scotland
adolf_meyer	place_of_death	baltimore
christian_august_of_saxe_zeitz	gender	male
simeon_uro	parents	stefan_uro_iii_de_anski_of_serbia
juliana_maria_of_brunswick_wolfenbuttel	spouse	frederick_v_of_denmark
mai_zetterling	place_of_birth	vasteras
lady_rose_mclaren	parents	charles_paget_6th_marquess_of_anglesey
thursday_october_christian	place_of_birth	pitcairn_islands
frederick_v_of_denmark	parents	sophia_magdalen_of_brandenburg-kulmbach
sergei_akhromeyev	cause_of_death	suicide
ramses_shaffy	location	amsterdam
hugh_john_casey	gender	male
ranald_macdougall	gender	male
ivar_haglund	place_of_birth	seattle
arsenio_erico	gender	male
louis_the_pious	parents	charlemagne
galswintha	parents	athanagild
george_jessel	location	the_bronx
vladimir_i_lenin	profession	economist
william_wilkins	profession	judge
jun_ishikawa_1899	place_of_birth	tokyo
tsuru_aoki	location	tokyo
alejandro_agustin_lanusse	place_of_death	buenos_aires
giambologna	gender	male
william_backhouse_astor_jr	children	john_jacob_astor_iv
john_murray_1st_marquess_of_atholl	gender	male
benny_bailey	place_of_death	amsterdam
harriet_beecher_stowe	location	cincinnati_ohio
adolf_von_harnack	institution	university_of_leipzig
christian_gottlob_neefe	gender	male
frederick_o_prince	institution	harvard_university
lord_alfred_douglas	religion	roman_catholic_church
edward_victor_appleton	institution	university_of_edinburgh
john_martin_1839	cause_of_death	pneumonia
sabahattin_ali	profession	journalist
jacob_theodor_klein	profession	diplomat
rudolf_serkin	place_of_birth	eger
babe_london	gender	female
charles_louis_frederick_duke_of_mecklenburg_mirow	children	duke_george_augustus_of_mecklenburg
andre_massena	location	nice
joseph_ludwig_colmar	gender	male
marek_kotanski	profession	psychologist
arthur_latham_perry	gender	male
leopold_ii_holy_roman_emperor	children	rudolf_cardinal_von_habsburg_lothringen
jon_stone	gender	male
deborah_digges	place_of_birth	jefferson_city
james_sample	gender	male
philip_neri	location	florence
simon_forman	gender	male
jeremy_beadle	nationality	england
sonya_levien	place_of_death	hollywood
paul_strand	gender	male
hussein_of_jordan	parents	talal_of_jordan
heinrich_freiherr_von_hess	nationality	austria
charles_a_platt	profession	architect
arthur_schnitzler	gender	male
hussey_vivian_1st_baron_vivian	gender	male
stanley_ketchel	place_of_birth	grand_rapids
hugh_b_cave	nationality	jamaica
isaac_jacob_schmidt	place_of_birth	amsterdam
rufus_p_spalding	gender	male
torbern_bergman	gender	male
lynn_redgrave	parents	michael_redgrave
adolph_sutro	place_of_death	san_francisco
jacob_christian_jacobsen	nationality	denmark
milton_h_erickson	profession	psychologist
georgie_mee	nationality	england
max_skladanowsky	profession	inventor
giuseppe_piazzi	religion	roman_catholic_church
george_cholmondeley_1st_marquess_of_cholmondeley	nationality	united_kingdom
friedrich_hegar	place_of_death	zurich
andy_kaufman	religion	judaism
william_merritt_chase	profession	painter
jaroslav_durych	place_of_birth	hradec_kralove
willem_blaeu	place_of_death	amsterdam
gustav_i_of_sweden	children	princess_elizabeth_of_sweden
gedong_bagus_oka	nationality	indonesia
lynne_carver	gender	female
don_arden	profession	publicist
antoine_francois_comte_de_fourcroy	place_of_death	paris
william_j_mcgill	institution	harvard_university
maximilian_von_montgelas	gender	male
charmaine_dragun	place_of_birth	western_australia
alice_betty_stern	children	otto_frank
david_lowry_swain	gender	male
andres_bonifacio	location	manila
johnnie_ray	location	portland
amenhotep_son_of_hapu	place_of_birth	nile_delta
edward_john_thye	gender	male
akhmad_kadyrov	place_of_birth	karaganda
daniel_itzig	ethnicity	germans
lou_andreas-salome	location	saint_petersburg
john_m_ashbrook	place_of_birth	johnstown_ohio
piet_paaltjens	location	leeuwarden
mario_benedetti	nationality	uruguay
mikhail_tarielovich_loris-melikov	place_of_death	nice
edmund_mcilhenny	location	hagerstown
james_munro_1826	gender	male
frances_parkinson_keyes	gender	male
paul_johann_ludwig_von_heyse	gender	male
arthur_onslow	gender	male
jean_francois_dandrieu	gender	male
andrew_sherratt	cause_of_death	myocardial_infarction
mary_lee_settle	cause_of_death	lung_cancer
ferdinand_i_of_romania	place_of_birth	sigmaringen
karl_christian_friedrich_krause	gender	male
heinrich_kley	place_of_death	munich
allan_pinkerton	religion	atheism
john_f_bolt	place_of_birth	laurens
strato_of_lampsacus	religion	atheism
johann_radon	gender	male
jolenta_of_poland	parents	bela_iv_of_hungary
william_livingston	location	albany
frank_mccoppin	gender	male
heinrich_otto_wieland	place_of_birth	pforzheim
frederick_augustus_abel	institution	university_of_westminster
john_hoskins_stone	place_of_birth	charles_county
h_emory_widener_jr	place_of_birth	abingdon_virginia
olaf_ii_of_norway	children	magnus_i_of_norway
agustin_jeronimo_de_iturbide_y_huarte	parents	agustin_de_iturbide
olof_hanson	place_of_death	seattle
arnold_adolph_berthold	nationality	germany
yukiko_okada	profession	record_producer
ramon_maria_narvaez_y_campos_1st_duke_of_valencia	place_of_death	madrid
r_venkataraman	religion	hindu
eugene_herbert	religion	roman_catholic_church
conroy_maddox	nationality	england
francis_l_sullivan	gender	male
charles_cotesworth_pinckney	location	south_carolina
barbette_1904	location	round_rock
frederic_vester	location	saarbrucken
vittorio_brambilla	profession	racecar_driver
john_j_williams	religion	united_methodist_church
minnie_marx	spouse	sam_marx
rudolf_vrba	gender	male
elio_bartolini	nationality	italy
alexander_rustow	profession	economist
charles_the_bald	children	louis_the_stammerer
george_spencer_churchill_8th_duke_of_marlborough	children	charles_spencer_churchill_9th_duke_of_marlborough
matt_gadsby	nationality	england
maria_theresa_of_austria	children	leopold_ii_holy_roman_emperor
john_fairfield	gender	male
thomas_cranmer	institution	jesus_college_cambridge
william_morris_davis	parents	edward_m_davis
walter_a_haas_jr	location	san_francisco
werner_abrolat	place_of_birth	sovetsk
augustus_garrett	gender	male
pieter_nuyts	place_of_birth	middelburg
louis_moreau_gottschalk	profession	composer
robert_baron	nationality	scotland
niels_henrik_abel	location	norway
frederick_stone	gender	male
joseph_wheeler	location	augusta
paul_painleve	gender	male
eilhard_mitscherlich	location	germany
uta_hagen	location	gottingen
thomas_anstey_guthrie	profession	novelist
edward_gent	place_of_death	ruislip
igor_stravinsky	location	saint_petersburg
wayman_tisdale	location	tulsa
charles_chapman_grafton	location	boston_massachusetts
andrea_orcagna	nationality	italy
marvin_miller_1913	gender	male
louella_parsons	profession	journalist
princess_augusta_charlotte_of_wales	gender	female
stefan_krcmery	place_of_birth	mosovce
beatrice_lillie	gender	female
richard_oconnor_1851	place_of_death	darlinghurst_new_south_wales
taqi_al-din	profession	astronomer
richard_august_carl_emil_erlenmeyer	gender	male
franjo_kuha	place_of_death	zagreb
joe_malone	location	quebec_city
nicolaus_copernicus	institution	university_of_bologna
harry_elte	profession	architect
susanna_wesley	gender	female
barzillai_lew	ethnicity	african_american
lana_turner	place_of_death	century_city
karl_gustav_cassel	place_of_death	jonkoping
vasili_i_of_russia	parents	dmitri_donskoi
karl_josef_batthyany	gender	male
powhatan_beaty	place_of_death	cincinnati_ohio
kiichi_aichi	place_of_death	tokyo
matthew_axelson	gender	male
princess_maria_teresa_of_bourbon_two_sicilies	parents	mathilde_ludovika_duchess_in_bavaria
j_p_morgan	parents	junius_spencer_morgan
pierre_derbigny	place_of_birth	laon
barbara_kelly	cause_of_death	cancer
johann_nepomuk_schelble	gender	male
marcelo_fromer	place_of_birth	sao_paulo
henry_taylor_blow	location	st_louis_missouri
jack_buck	gender	male
samuel_s_phelps	gender	male
abigail_campbell_kawananakoa	children	abigail_kapiolani_kawananakoa
frank_worrell	cause_of_death	leukemia
john_russell_young	gender	male
marcello_bacciarelli	nationality	italy
edward_iv_of_england	children	mary_of_york
anatoly_marienhof	gender	male
paul_johann_ludwig_von_heyse	place_of_death	munich
peter_diamond	gender	male
joe_glazer	location	akron
john_schoenherr	gender	male
lottie_collins	gender	female
james_dickey	institution	vanderbilt_university
elena_pavlovna_of_wurttemberg	spouse	grand_duke_michael_pavlovich_of_russia
pavel_demidov	place_of_death	mainz
robert_devereux_2nd_earl_of_essex	gender	male
tutankhamun	cause_of_death	gangrene
p_g_wodehouse	nationality	england
lloyd_c_stark	place_of_death	clayton
aziz_mian	place_of_birth	delhi
bernard_fernow	place_of_birth	inowroclaw
matthew_fontaine_maury	place_of_birth	spotsylvania
alfred_lunt	spouse	lynn_fontanne
augustus_smith	gender	male
grand_duchess_maria_nikolaevna_of_russia	nationality	russia
hiram_price	place_of_birth	washington_county_pennsylvania
schlitzie	place_of_birth	the_bronx
mostafa_chamran	institution	university_of_texas_at_austin
jose_gomez_sicre	place_of_birth	matanzas
dean_reed	place_of_birth	denver
frankie_campbell	place_of_death	san_francisco
princess_louise_victoire_dorleans_alencon	children	prince_joseph_clemens_of_bavaria
jacobus_kapteyn	location	gelderland
deanna_cremin	gender	female
alexandra_iosifovna_of_altenburg	parents	amelia_of_wurttemberg
jack_j_catton	location	berkeley_california
edward_of_portugal	gender	male
elisabeth_of_bavaria	parents	maximilian_joseph_duke_in_bavaria
frederic_cuvier	gender	male
bobby_fuller	profession	musician
william_wirt	place_of_birth	bladensburg
louise_mountbatten	parents	princess_victoria_of_hesse_and_by_rhine
prasanta_chandra_mahalanobis	gender	male
josiah_t_walls	place_of_birth	winchester_virginia
screamin_jay_hawkins	gender	male
marion_zimmer_bradley	profession	author
homer_h_norton	place_of_death	college_station
george_s_patton	gender	male
henry_thornton_1871	gender	male
thomas_dudley	gender	male
alvin_m_owsley	place_of_death	dallas
adelaide_of_lowenstein_wertheim_rosenberg	place_of_birth	kleinheubach
david_hoggan	place_of_death	menlo_park
john_garfield	cause_of_death	cardiovascular_disease
nat_pendleton	place_of_birth	davenport
john_c_walton	location	indianapolis
jonathan_swift	location	county_dublin
ian_fleming	profession	novelist
spiro_agnew	place_of_birth	towson
charles_cotesworth_pinckney	institution	westminster_school
leopold_prince_of_hohenzollern_sigmaringen	children	ferdinand_i_of_romania
pat_harrison	place_of_death	washington_united_states
giovanni_battista_cipriani	gender	male
hannah_glasse	gender	female
yeshayahu_leibowitz	religion	judaism
dizzy_gillespie	location	south_carolina
sterling_hayden	profession	author
miltos_sachtouris	gender	male
george_spencer_4th_duke_of_marlborough	children	george_spencer_churchill_5th_duke_of_marlborough
ernst_rudiger_von_starhemberg	location	graz
martin_luther_king_jr	ethnicity	african_american
leonid_shamkovich	cause_of_death	parkinsons_disease
george_halas	cause_of_death	cancer
gustavus_richard_brown	location	maryland
carl_philipp_emanuel_bach	place_of_birth	weimar
james_goldsmith	nationality	united_kingdom
hans_holbein_the_younger	cause_of_death	bubonic_plague
leopold_ii_grand_duke_of_tuscany	children	archduke_john_salvator_of_austria
ilija_arnautovic	gender	male
william_miles_maskell	place_of_death	wellington
urbano_rattazzi	gender	male
roswell_s_ripley	location	ohio
taksony_of_hungary	gender	male
william_morris_davis	location	pasadena
john_freke	place_of_birth	england
louis_philippe_i_duke_of_orleans	parents	auguste_marie_johanna_of_baden_baden
rumer_godden	place_of_birth	sussex
olive_oatman	gender	female
louis_renault	gender	male
sol_lewitt	location	hartford_connecticut
alex_higgins	place_of_birth	belfast
pope_nicholas_i	place_of_death	vatican_city
john_rowan	gender	male
fred_silva	cause_of_death	myocardial_infarction
gioacchino_rossini	location	pesaro
emma_of_normandy	children	harthacanute
watson_c_squire	gender	male
warren_tufts	place_of_death	placerville
dave_mallett	profession	singer-songwriter
alistair_cooke	nationality	united_kingdom
emil_racovita	gender	male
john_w_powell	gender	male
per_engdahl	place_of_death	malmo
joan_lowell	profession	film_director
lord_hugh_seymour	gender	male
manuel_arteaga_y_betancourt	place_of_birth	camaguey
george_taylor	gender	male
alfonso_vii_of_leon	ethnicity	galician_people
eunice_norton	gender	female
gina_bachauer	location	attica
john_adams_dix	place_of_birth	boscawen
john_dee	place_of_death	mortlake
jose_m_lopez	gender	male
charles_mackerras	place_of_birth	schenectady
john_s_curtiss	place_of_death	honolulu
ernst_stromer	place_of_death	erlangen
henry_latimer	place_of_death	philadelphia
alfred_lion	ethnicity	germans
golda_meir	place_of_death	jerusalem
georg_lindemann	gender	male
elena_of_greece_and_denmark	parents	sophia_of_prussia
lane_kirkland	place_of_death	washington_united_states
hermann_van_pels	religion	judaism
wilhelm_haferkamp	nationality	germany
josiah_s_johnston	gender	male
james_bateman	gender	male
kanteerava_narasimharaja_wadiyar	children	jayachamaraja_wodeyar_bahadur
frederick_richard_simms	gender	male
cearbhall_o_dalaigh	profession	journalist
toby_edward_rosenthal	gender	male
henric_trenk	nationality	romania
karl_christian_friedrich_krause	place_of_death	munich
james_weaver	gender	male
alice_of_the_united_kingdom	parents	victoria_of_the_united_kingdom
pierre_de_coubertin	ethnicity	french_people
william_a_richardson	nationality	mexico
nicolae_iorga	profession	journalist
amos_milburn	profession	singer
albert_coady_wedemeyer	gender	male
toby_edward_rosenthal	place_of_death	munich
edward_james	spouse	tilly_losch
soong_may-ling	children	chiang_wei-kuo
nadezhda_konstantinovna_krupskaya	profession	first_lady
gary_powers	profession	aviator
liaquat_ali_khan	location	muzaffarnagar
jacqueline_de_longwy	gender	female
clementine_churchill_baroness_spencer_churchill	children	randolph_churchill
william_rehnquist	ethnicity	swedish_american
hermann_van_pels	nationality	germany
charles_thomson_rees_wilson	gender	male
betty_berzon	ethnicity	white_american
yasmin_ahmad	profession	film_director
jerry_garcia	gender	male
richard_courant	nationality	germany
aylett_r_cotton	place_of_death	san_francisco
edward_gordon_craig	gender	male
montgomery_atwater	place_of_birth	baker_city
zadoc_kahn	profession	rabbi
maria_theresa_of_austria_and_tuscany	spouse	charles_albert_of_sardinia
alvaro_del_portillo	gender	male
paul_ludwig_ewald_von_kleist	place_of_death	vladimir
jade_goody	gender	female
henry_l_benning	institution	university_of_georgia
james_carlile	nationality	united_kingdom
james_b_ray	religion	methodism
reg_birch	location	kilburn
ferdinand_eisenstein	gender	male
igor_stravinsky	location	nice
william_stenger	location	philadelphia
peter_mazur	place_of_death	lausanne
boris_blacher	place_of_birth	china
guido_reni	place_of_birth	bologna
roberto_urdaneta_arbelaez	place_of_birth	bogota
john_gilbert_1899	place_of_death	hollywood
joan_crawford	cause_of_death	myocardial_infarction
boris_sagal	gender	male
lance_sijan	gender	male
zora_neale_hurston	ethnicity	african_american
max_frisch	place_of_death	zurich
phillip_c_katz	place_of_birth	san_francisco
eleanor_stewart_princess_of_scotland	parents	joan_beaufort_queen_of_scotland
michael_morris_1st_baron_killanin	profession	judge
james_nasmyth	nationality	scotland
cozy_cole	profession	drummer
marty_hogan	location	youngstown
janet_gaynor	gender	female
felice_varesi	place_of_death	milan_italy
george_baxt	ethnicity	white_american
catherine_dickens	gender	female
hussein_bin_ali_sharif_of_mecca	place_of_death	amman
adolf_cardinal_bertram	location	hildesheim
george_kingsley_zipf	institution	harvard_college
eleonora_maria_josefa_of_austria	place_of_birth	regensburg
rudolf_serkin	gender	male
jon_lucien_tortola	place_of_death	orlando
jonathan_netanyahu	gender	male
moshe_mordechai_epstein	religion	judaism
jarallah_omar	cause_of_death	assassination
john_fraser_1823	institution	university_of_aberdeen
henry_temple_3rd_viscount_palmerston	institution	st_johns_college_cambridge
thomas_andrews	gender	male
henry_duncan	ethnicity	scottish_people
arseniy_zakrevskiy	place_of_death	florence
russ_conway	nationality	england
mikolaj_chopin	gender	male
arthur_shawcross	gender	male
amedeo_nazzari	cause_of_death	cardiac_arrest
marios_tokas	profession	singer
gilbert_frankau	gender	male
maria_helena_vieira_da_silva	place_of_death	paris
stefan_uro_iii_de_anski_of_serbia	gender	male
jose_emilio_gonzalez	gender	male
carl_auer_von_welsbach	location	vienna
adolf_von_harnack	location	erlangen
gabino_barreda	nationality	mexico
charles_s_farnsworth	gender	male
petro_konashevych	place_of_birth	ukraine
ivan_pavlov	profession	physiologist
frederick_j_osterling	profession	architect
frederic_william_farrar	nationality	united_kingdom
alexander_sakharoff	place_of_death	siena
elijah_ward	location	new_york_state
louis_xv_of_france	children	marie_adelaide_madame_quatrieme
prince_adalbert_of_bavaria	parents	ludwig_i_of_bavaria
earl_long	location	louisiana
eulalia_duchess_of_galliera	parents	isabella_ii_of_spain
edda_de_los_rios	place_of_death	paraguay
john_f_shafroth	place_of_birth	fayette_missouri
waldemar_haffkine	location	calcutta
henry_montagu_1st_earl_of_manchester	gender	male
peter_boyle	gender	male
franz_von_lenbach	place_of_death	munich
heinrich_christian_schumacher	profession	astronomer
hunter_johnson	location	north_carolina
m_g_ramachandran	place_of_death	chennai
adolf_von_donndorf	place_of_death	stuttgart
valdemar_psilander	place_of_death	copenhagen
frances_benjamin_johnston	profession	journalist
james_garfield	cause_of_death	myocardial_infarction
william_chatterton_dix	place_of_birth	bristol
philip_macdonald	place_of_death	woodland_hills
abraham_colles	profession	surgeon
john_rouse_merriott_chard	gender	male
pietro_germi	ethnicity	italian_people
ramesses_iv	parents	ramesses_iii
ivan_rand	gender	male
t-bone_walker	profession	musician
mickey_spillane_1934	ethnicity	irish_american
wendell_cushing_neville	institution	united_states_naval_academy
sir_eric_pearce	gender	male
don_arden	place_of_birth	cheetham_hill
simon_bolivar	place_of_birth	caracas
jean_frederic_phelypeaux_comte_de_maurepas	gender	male
joseph_szigeti	gender	male
anton_lavey	location	san_francisco
lewis_terman	gender	male
karl_christian_friedrich_krause	nationality	germany
edward_seymour_1st_duke_of_somerset	gender	male
antoine_philippe_duke_of_montpensier	place_of_birth	paris
john_m_ashbrook	institution	ohio_state_university
peter_lorre	cause_of_death	stroke
captain_william_shakespear	nationality	united_kingdom
evgenii_miller	nationality	russia
ottorino_respighi	profession	conducting
isaac_goodnow	gender	male
ludwig_salvator	place_of_birth	florence
charles_hernu	place_of_birth	quimper
marcel_gromaire	gender	male
pat_harrison	gender	male
archduke_carl_ludwig_of_austria	spouse	maria_annunciata_of_the_two_sicilies
adam_smith	profession	economist
w_w_hodkinson	location	ogden
judith_of_hungary	parents	geza_of_hungary
christos_tsigiridis	profession	electrical_engineer
josiah_willard_gibbs	place_of_death	new_haven
gerrie_knetemann	gender	male
acislo_antonio_palomino_de_castro_y_velasco	place_of_death	madrid
charles_h_crane	place_of_death	washington_united_states
jean-baptiste_jourdan	place_of_birth	limoges
constance_georgine_countess_markiewicz	nationality	united_kingdom
curd_jurgens	location	munich
alexandrine_of_mecklenburg-schwerin	gender	female
waite_hoyt	institution	erasmus_hall_high_school
michael_foster_1836	nationality	united_kingdom
infanta_isabel_duchess_of_burgundy	parents	philippa_of_lancaster
helmuth_stieff	gender	male
ailwyn_fellowes_1st_baron_ailwyn	profession	farmer
robert_urich	institution	florida_state_university
ruhollah_khomeini	gender	male
clarence_abiathar_waldo	institution	syracuse_university
john_aislabie	nationality	england
robert_urich	religion	roman_catholic_church
janos_cardinal_csernoch	religion	roman_catholic_church
lavoslav_ruzicka	profession	scientist
moritz_schlick	cause_of_death	murder
romualdas_marcinkus	gender	male
mikolaj_chopin	children	frederic_chopin
linus_pauling	institution	california_institute_of_technology
johann_georg_wagler	cause_of_death	firearm
orazio_riminaldi	gender	male
aernout_van_der_neer	location	amsterdam
walter_abel	location	saint_paul
dag_hammarskjold	profession	diplomat
adela_rogers_st_johns	profession	journalist
josef_barak	profession	journalist
henry_phipps	gender	male
jack_london	profession	journalist
john_f_fitzgerald	place_of_birth	boston_massachusetts
perceval_landon	nationality	england
antonio_segni	location	sassari
adrienne_shelly	cause_of_death	murder
mei_qing	profession	painter
julia_flavia	parents	titus
piano_red	profession	singer
benizelos_rouphos	place_of_birth	patras
olof_swartz	place_of_birth	norrkoping
pierre_girard	place_of_death	paris
rainer_maria_rilke	gender	male
benjamin_m_miller	location	selma
john_l_pennington	gender	male
princess_alexandra_of_bavaria	parents	ludwig_i_of_bavaria
mr_s_hiritzo	cause_of_death	severe_trauma
brian_hildebrand	profession	wrestler
mabel_albertson	place_of_death	santa_monica_california
harry_holtzman	gender	male
august_wohler	place_of_birth	soltau
johnny_j	gender	male
consuelo_vanderbilt	spouse	charles_spencer_churchill_9th_duke_of_marlborough
erik_acharius	gender	male
norton_p_chipman	religion	baptist
ruth_cardoso_1930	profession	first_lady
karl_friedrich_abel	place_of_birth	kothen
jose_antonio_burciaga	profession	poet
miep_gies	location	vienna
marc_chagall	profession	visual_artist
i_l_patterson	profession	merchant
maria_theresa_of_austria	children	archduke_maximilian_franz_of_austria
henry_l_stimson	institution	yale_college
peter_finch	nationality	australia
philip_booth	gender	male
jan_smuts	religion	calvinism
kamehameha_iv	place_of_death	honolulu
james_d_howe	location	south_carolina
oswald_lohse	nationality	germany
napoleon_eugene_prince_imperial	parents	eugenie_de_montijo
natalie_kingston	gender	female
amy_beach	profession	composer
jerry_wald	gender	male
henri_cernuschi	location	milan_italy
sitamun	parents	amenhotep_iii
marty_robbins	location	nashville_tennessee
el_greco	ethnicity	greeks
aphra_behn	place_of_birth	england
peter_townsend	cause_of_death	stomach_cancer
yirmisekiz_mehmed_celebi	place_of_birth	edirne
vittorio_brambilla	gender	male
leon_mathot	gender	male
jack_clayton	place_of_death	berkshire
gerald_goodlake	place_of_birth	faringdon
luigi_ferdinando_marsigli	nationality	italy
joseph_wharton	parents	deborah_fisher_wharton
john_scott_youll	gender	male
edda_de_los_rios	gender	female
jesse_macy	institution	johns_hopkins_university
louise_of_savoy	children	francis_i_of_france
david_bruce_1855	ethnicity	scottish_people
isabella_of_france	children	eleanor_of_woodstock
jules_paul_benjamin_delessert	gender	male
cormac_mcanallen	gender	male
mikhail_vasilyevich_popov	gender	male
rattana_pestonji	gender	male
jack_webb	spouse	julie_london
coluche	place_of_birth	paris
wolfgang_spate	gender	male
jimmy_quillen	location	kingsport
george_gamow	place_of_birth	odessa
charles_jasper_selwyn	gender	male
thomas_andrews	profession	businessperson
anthony_quinn	profession	film_director
bill_greenwood	place_of_death	philadelphia
john_w_reynolds	location	green_bay
adrianus_valerius	gender	male
mickey_spillane_1934	cause_of_death	murder
nicholas_van_dyke	gender	male
ichabod_washburn	profession	businessperson
nadezhda_konstantinovna_krupskaya	nationality	russia
abel_p_upshur	gender	male
byam_shaw	gender	male
antonio_lombardo_1458	gender	male
carlos_finlay	gender	male
winston_hibler	profession	film_director
wallace_m_greene	location	vermont
rafael_sotomayor_gaete	gender	male
albrecht_durer	nationality	germans
otto_henry_elector_palatine	nationality	germany
frank_abbatemarco	cause_of_death	murder
robert_allan_fitzgerald	institution	trinity_college_cambridge
cyril_shaps	institution	royal_academy_of_dramatic_art
darrell_russell	place_of_birth	pensacola
brian_faulkner	institution	queens_university_of_belfast
robert_e_lee	parents	henry_lee
alice_calhoun	cause_of_death	cancer
henry_hayman_toulmin	place_of_death	hertfordshire
ivan_mestrovic	place_of_death	south_bend
norman_krasna	profession	playwright
lee_eun-ju	cause_of_death	suicide
frank_wead	profession	aviator
mija_aleksic	gender	male
otto_butschli	nationality	germany
dorothy_l_sayers	nationality	england
travis_banton	gender	male
pietro_benvenuti	place_of_birth	arezzo
esteban_echeverria	location	buenos_aires
elsie_janis	location	beverly_hills
maria_antonietta_of_spain	children	marie_therese_of_savoy
barbara_jordan	place_of_birth	houston
sugar_ray_robinson	gender	male
balan_k_nair	gender	male
alisher_saipov	cause_of_death	murder
pope_benedict_iv	gender	male
henriette_adelaide_of_savoy	children	maria_anna_of_bavaria
jim_hogg	profession	journalist
giulio_caccini	gender	male
amy_johnson	place_of_birth	kingston_upon_hull
reine_davies	gender	female
freddie_hubbard	profession	bandleader
david_o_selznick	profession	film_director
wilhelmine_von_sagan	parents	peter_von_biron
william_murray_1st_earl_of_mansfield	institution	westminster_school
joseph_smith_jr	location	illinois
eduardo_serrano	location	caracas
andrew_fletcher	nationality	scotland
leslie_scarman_baron_scarman	profession	judge
parviz_natel-khanlari	place_of_death	tehran
ethelred_the_unready	children	edward_the_confessor
katherine_anne_porter	profession	novelist
duane_josephson	gender	male
joseph_barber_lightfoot	gender	male
david_t_ansted	gender	male
terry_nation	profession	scriptwriter
eric_drummond_7th_earl_of_perth	nationality	scotland
joan_vollmer	spouse	william_s_burroughs
ernest_cassel	religion	judaism
edward_warner	nationality	united_kingdom
ilya_pyatetskii-shapiro	nationality	israel
wilhelmine_of_prussia	spouse	william_i_of_the_netherlands
thomas_burke	gender	male
pierre_paul_puget	profession	architect
pat_ocallaghan	place_of_death	clonmel
maria_theresa_of_austria	place_of_death	vienna
ignacy_krasicki	gender	male
greg_morris	cause_of_death	brain_tumor
ivan_pavlov	nationality	soviet_union
francis_dickens	parents	catherine_dickens
ira_levin	institution	new_york_university
john_porter_east	institution	earlham_college
floyd_k_haskell	place_of_death	washington_united_states
jozsef_szen	gender	male
llewellyn_alberic_emilius_price-davies	gender	male
yone_noguchi	profession	essayist
sophia_dorothea_of_hanover	spouse	frederick_william_i_of_prussia
edward_francis_hutton	location	palm_beach
alice_claypoole_gwynne	children	alfred_gwynne_vanderbilt
don_arden	gender	male
floyd_k_haskell	location	morristown
alexander_bogdanov	ethnicity	belarusians
hugh_algernon_weddell	profession	botanist
s_w_t_lanham	place_of_death	texas
stefan_slopek	gender	male
robert_hare	place_of_birth	philadelphia
samuel_benjamin_sofer	place_of_birth	bratislava
pietro_belluschi	profession	architect
ervin_cerny	nationality	czech_republic
john_eaton	place_of_death	washington_united_states
a_bartlett_giamatti	institution	yale_university
adrien_zeller	gender	male
friedrich_trendelenburg	cause_of_death	cancer
johann_jacob_dillenius	nationality	germany
edward_count_palatine_of_simmern	gender	male
procopius_0326	parents	julian_the_apostate
hezekiah	children	manasseh_of_judah
richard_de_zoysa	gender	male
neal_cassady	place_of_birth	salt_lake_city
frederick_low	place_of_death	san_francisco
john_arthur_spenkelink	gender	male
gerald_goodlake	nationality	united_kingdom
jacob_israel_de_haan	cause_of_death	assassination
enrique_granados	nationality	spain
wolfgang_pauli	ethnicity	austrian-american
anne_ramsey	institution	bennington_college
herbert_akroyd_stuart	location	halifax
alexandr_griboyedov	gender	male
oliver_heaviside	place_of_death	torquay
reuben_henry_tucker_iii	place_of_birth	connecticut
pierre-jules_hetzel	gender	male
mungo_park	ethnicity	scottish_people
gustav_mie	place_of_death	freiburg
mikolaj_the_black_radziwill	spouse	el_bieta_szydlowiecka
frederick_knefler	place_of_death	indianapolis
cesar-francois_cassini_de_thury	parents	jacques_cassini
george_frederick_bristow	gender	male
george_spencer_churchill_5th_duke_of_marlborough	parents	george_spencer_4th_duke_of_marlborough
johann_christian_schuch	gender	male
philip_viii_duc_dorleans	spouse	archduchess_maria_dorothea_of_austria
august_anheuser_busch_sr	profession	businessperson
al_parker	cause_of_death	aids
gabriel_richard	gender	male
willem_blaeu	profession	publishing
jacobus_van_looy	gender	male
queen_maya	spouse	jinpyeong_of_silla
h_emory_widener_jr	cause_of_death	lung_cancer
hugh_paddick	nationality	england
hans_assi_hahn	place_of_death	munich
andrzej_hlawiczka	religion	lutheranism
adnan_menderes	gender	male
gerald_m_boyd	place_of_birth	st_louis_missouri
robert_lowe_1st_viscount_sherbrooke	nationality	england
gustaf_retzius	gender	male
ogata_korin	nationality	japan
israel_russell	profession	science_writer
sophia_dorothea_of_hanover	children	princess_anna_amalia_of_prussia
robert_armstrong_1890	place_of_death	santa_monica_california
anne_jean_marie_rene_savary	gender	male
jean_moreas	gender	male
josiah_whitney	institution	yale_university
victor_g_bloede	place_of_birth	dresden
dschinghis_khan	nationality	germany
farrer_herschell_1st_baron_herschell	gender	male
donald_watson	location	mexborough
federico_santa_maria	gender	male
john_jamison	parents	thomas_jamison
dovima	cause_of_death	liver_cancer
francisco_martinez_soria	place_of_death	barcelona
harold_richman	gender	male
charles_nicolle	place_of_death	tunis
szymon_bogumil_zug	nationality	germany
carl_robert_jakobson	profession	journalist
paavo_yrjola	place_of_birth	hameenkyro
frederic_leighton_1st_baron_leighton	nationality	united_kingdom
eldon_hoke	place_of_birth	seattle
dan_white	cause_of_death	suicide
mel_allen	place_of_birth	birmingham_alabama
mungo_park	gender	male
margaret_flagg_holmes	location	north_carolina
edward_vii_of_the_united_kingdom	place_of_birth	buckingham_palace
antony_francis_van_der_meulen	place_of_death	paris
barry_horne	place_of_death	worcester
george_w_malone	gender	male
miriam_cooper	place_of_death	charlottesville
gottfried_christoph_beireis	place_of_birth	muhlhausen
siegfried_kracauer	ethnicity	germans
miguel_antonio_caro	location	bogota
prince_bira	profession	racecar_driver
john_of_england	cause_of_death	dysentery
jinfei	spouse	guangxu_emperor
anne_killigrew	cause_of_death	smallpox
william_rehnquist	place_of_death	arlington
adela_florence_nicolson	cause_of_death	suicide
richard_may	cause_of_death	brain_tumor
sinclair_lewis	gender	male
joe_baksi	gender	male
malcolm_x	location	boston_massachusetts
stephen_lawrence	gender	male
lou_stathis	gender	male
wilhelm_launhardt	gender	male
hamoodur_rahman	nationality	pakistan
edward_of_portugal	spouse	leonor_of_aragon
millard_fuller	institution	university_of_alabama
joseph_vinoy	place_of_death	paris
marguerite_louise_dorleans	children	anna_maria_luisa_de_medici
max_gerson	nationality	germany
j_p_morgan	children	anne_morgan
robert_rawlinson	place_of_birth	bristol
suleiman_the_magnificent	gender	male
glauber_rocha	gender	male
thomas_e_watson	place_of_death	washington_united_states
salimuzzaman_siddiqui	nationality	pakistan
ed_pulaski	place_of_birth	ohio
william_dean_howells	location	ohio
vance_packard	institution	pennsylvania_state_university
herman_bang	nationality	denmark
gertrude_robinson	place_of_death	hollywood
john_dillinger	cause_of_death	firearm
gustav_heinemann	religion	lutheranism
john_flamsteed	nationality	england
albert_caquot	gender	male
lorenz_oken	place_of_birth	offenburg
henry_purcell	institution	westminster_school
john_dos_passos	institution	harvard_university
colin_mccahon	location	timaru
steve_fossett	place_of_birth	jackson_tennessee
thomas_harper_ince	place_of_birth	newport_rhode_island
george_abernethy	place_of_death	portland
ron_asheton	profession	musician
jimmy_mcculloch	profession	guitarist
hugo_vivian_hope_throssell	place_of_death	western_australia
richard_wagner	profession	music_critic
bill_nicholson_1914	location	maryland
luc_ferrari	gender	male
eugene_aynsley_goossens	nationality	england
john_chancellor	profession	journalist
james_w_robinson_1791	gender	male
marianne_brandt	nationality	germany
edward_b_watson	gender	male
george_trumbull_ladd	religion	congregational_church
abu_nidal	cause_of_death	firearm
liam_lawlor	gender	male
mohammed_baqir_al-hakim	gender	male
alexander_pistolkors	parents	olga_valerianovna_paley
richard_wagner	ethnicity	germans
tommy_godfrey	nationality	england
robert_kearns	place_of_death	baltimore
basil_spence	profession	architect
evie_greene	profession	singer
daniel_woodson	location	virginia
park_chung_hee	ethnicity	korean_people
marie_magdalene_charlotte_ackermann	gender	female
richard_neville_16th_earl_of_warwick	children	anne_neville
wallace_m_greene	place_of_death	alexandria_virginia
robert_anton_wilson	religion	agnosticism
eduard_winkelmann	place_of_death	heidelberg
albert_of_saxe-coburg_and_gotha	children	princess_helena_of_the_united_kingdom
heinrich_hoffmann_1809	nationality	germany
simun_av_skardi	gender	male
mary_dimmick_harrison	spouse	benjamin_harrison
mariana_of_austria	gender	female
richard_tucker	profession	hazzan
friedrich_von_der_trenck	place_of_death	paris
frederick_i_margrave_of_brandenburg-ansbach	children	george_margrave_of_brandenburg_ansbach
alexandra_fyodorovna	parents	louise_of_mecklenburg-strelitz
grand_duke_konstantin_nikolayevich_of_russia	parents	alexandra_fyodorovna
winston_hibler	place_of_death	burbank
john_teasman	location	new_jersey
robin_tyner	profession	singer
desi_arnaz	profession	musician
magnus_hirschfeld	place_of_death	nice
william_paget_1st_baron_paget	institution	trinity_hall_cambridge
amelia_of_wurttemberg	gender	female
laurence_ginnell	profession	author
luis_donaldo_colosio	cause_of_death	assassination
rosa_parks	gender	female
ludwig_i_of_bavaria	children	princess_hildegard_of_bavaria
harriet_beecher_stowe	location	hartford_connecticut
tomas_macgiolla	nationality	republic_of_ireland
maria_pilsudska	gender	female
phyllis_haver	gender	female
muramatsu_sh_fu	profession	novelist
clarenore_stinnes	nationality	germany
fielding_bradford_meek	place_of_death	washington_united_states
julius_franks	profession	american_football_player
betty_amann	place_of_birth	pirmasens
theodosius_i	spouse	aelia_flaccilla
karl_theodor_bayrhoffer	nationality	germany
archduchess_maria_josepha_of_austria	cause_of_death	smallpox
c_s_forester	profession	novelist
elizabeth_patterson_bonaparte	place_of_death	baltimore
louise_of_great_britain	gender	female
bulleh_shah	gender	male
andrea_orcagna	location	tuscany
ilya_pyatetskii-shapiro	gender	male
frederick_v_of_denmark	spouse	juliana_maria_of_brunswick_wolfenbuttel
junichiro_tanizaki	institution	university_of_tokyo
august_stramm	nationality	germany
john_eaton	place_of_birth	halifax_county
andre_kertesz	place_of_death	new_york_state
leopold_infeld	nationality	poland
mieszko_i_of_poland	parents	siemomysl
zenko_suzuki	place_of_death	tokyo
w_w_rouse_ball	nationality	england
francisco_pelsaert	place_of_death	jakarta
victoria_of_the_united_kingdom	children	victoria_princess_royal
mary_tudor	parents	henry_vii_of_england
john_xantus_de_vesey	gender	male
charles_william_ferdinand_duke_of_brunswick	children	caroline_of_brunswick
arseniy_zakrevskiy	gender	male
steve_allen	cause_of_death	cardiovascular_disease
vasily_kalinnikov	place_of_death	yalta
erik_jan_hanussen	place_of_birth	vienna
julie_london	place_of_death	encino
colin_macinnes	profession	novelist
louise_of_great_britain	spouse	frederick_v_of_denmark
ehmede_xani	gender	male
louis-philippe_pelletier	place_of_death	quebec_city
johann_ludwig_burckhardt	cause_of_death	dysentery
david_o_selznick	profession	film_producer
pierre_paul_prudhon	gender	male
charles_bennet_4th_earl_of_tankerville	nationality	england
keith_relf	profession	record_producer
kam_l_ud_d_n_behz_d	place_of_death	herat
hercules_l_dousman	location	michigan
frank_w_benson	place_of_birth	san_jose
ji_i_st_ibrny	profession	businessperson
robert_s_shankland	place_of_death	cleveland_ohio
tommaso_palamidessi	gender	male
hans_pfitzner	gender	male
pieter_post	location	haarlem
sterling_hayden	spouse	madeleine_carroll
archduchess_maria_josepha_of_austria	gender	female
john_napier	religion	protestantism
tiny_tim_1932	profession	singer
robert_farnon	profession	composer
benito_perez_galdos	gender	male
reginald_aldworth_daly	profession	geologist
jordan_cronenweth	gender	male
david_jackson_1934	cause_of_death	myocardial_infarction
ry_sei_kishida	gender	male
b_f_skinner	institution	harvard_university
joan_blondell	spouse	george_barnes_1892
elena_pavlovna_of_wurttemberg	place_of_birth	stuttgart
helen_thompson_sunday	spouse	billy_sunday
anthony_newley	cause_of_death	kidney_cancer
benay_venuta	location	san_francisco
andre_kertesz	profession	journalist
galla	gender	female
harold_taft	profession	tv_meteorologist
michael_de_la_pole_1st_earl_of_suffolk	children	michael_de_la_pole_2nd_earl_of_suffolk
cao_chong	place_of_death	china
ben_hogan	profession	golfer
louise-marie_of_france	place_of_death	ostend
thomas_sydenham	institution	pembroke_college_cambridge
mikhail_botvinnik	nationality	soviet_union
albert_j_beveridge	place_of_death	indianapolis
juan_luna	institution	ateneo_de_manila_university
jean-baptiste_jourdan	place_of_death	paris
leon_golub	institution	university_of_chicago
tilman_riemenschneider	location	thuringia
istvan_friedrich	gender	male
ferdinand_ii_of_portugal	location	vienna
adolf_freiherr_knigge	nationality	germany
joy_page	gender	female
max_planck	location	kiel
alexander_rustow	place_of_death	heidelberg
frederick_william_iii_of_prussia	children	alexandra_fyodorovna
s_w_t_lanham	gender	male
anna_deste	spouse	francis_duke_of_guise
kalman_kando	place_of_birth	pest
glenn_corbett	gender	male
jadin_wong	location	san_francisco
wilhelm_berger	place_of_birth	boston_massachusetts
john_winfield_wallace	place_of_birth	beaver_falls
mary_stalcup_markward	cause_of_death	congestive_heart_failure
joachim_carvallo	profession	architect
kenneth_s_wherry	gender	male
john_stricker	place_of_birth	frederick
binger_hermann	location	roseburg
friedrich_weinreb	gender	male
rainer_maria_rilke	profession	art_critic
henri_nouwen	location	gelderland
boris_sagal	spouse	marge_champion
eazy-e	profession	rapping
nathaniel_wyeth	place_of_birth	chadds_ford
blanca_errazuriz	location	vina_del_mar
raphael	place_of_birth	urbino
claude_brown	profession	novelist
charles_steggall	profession	composer
antoine_of_navarre	gender	male
muramatsu_sh_fu	gender	male
salomon_kalischer	location	torun
makhan_lal_chaturvedi	profession	essayist
abram_games	gender	male
sarah_bernhardt	religion	judaism
cozy_cole	ethnicity	african_american
antonio_santelia	gender	male
george_edward_grey	gender	male
wilhelm_count_of_schaumburg_lippe	gender	male
henry_cuyler_bunner	gender	male
pierre_paul_deherain	gender	male
e_t_a_hoffmann	nationality	germans
alexandre_vicomte_de_beauharnais	cause_of_death	guillotine
thomas_howard_21st_earl_of_arundel	children	henry_howard_22nd_earl_of_arundel
brigham_young	location	vermont
john_galen_howard	profession	architect
albert_king	profession	record_producer
prince_rostislav_of_russia	gender	male
nicolaus_otto	children	gustav_otto
ferdinand_cohn	profession	botanist
clarence_king	place_of_death	phoenix
an_wang	profession	inventor
peter_warlock	institution	christ_church_oxford
georges_franju	place_of_death	paris
chuck_jones	cause_of_death	cardiovascular_disease
max_von_stephanitz	place_of_death	dresden
lud_k_marold	gender	male
dan_white	ethnicity	irish_american
moritz_thausing	nationality	austria
amedee_de_noe	place_of_birth	paris
cornelis_vroom	gender	male
august_ludwig_von_schlozer	institution	uppsala_university
charles_wittenoom	location	western_australia
john_henry_hobart_brown	gender	male
augusta_viktoria_of_schleswig-holstein	spouse	william_ii_german_emperor
mija_aleksic	location	kragujevac
tammy_faye	cause_of_death	lung_cancer
dwight_d_eisenhower	gender	male
james_kennedy	place_of_death	st_andrews
stephen_crane	profession	novelist
r_venkataraman	nationality	india
desi_arnaz	place_of_death	del_mar
gustaf_lindblom	place_of_death	stockholm
anthony_minghella	place_of_birth	ryde
sarah_yorke_jackson	place_of_death	nashville_tennessee
william_luther_pierce	gender	male
puey_ungpakorn	ethnicity	thai_chinese
otto_frank	spouse	edith_frank_hollander
karl_friedrich_mohr	place_of_birth	koblenz
hall_caine	nationality	england
william_johnson_sollas	gender	male
charles_w_field	place_of_birth	woodford_county_kentucky
frederick_rolfe	nationality	england
billy_rogell	cause_of_death	pneumonia
wini_shaw	place_of_birth	san_francisco
erika_mann	spouse	gustaf_grundgens
stefan_stambolov	ethnicity	bulgarians
lili_uokalani	place_of_death	honolulu
sammy_davis_jr	place_of_birth	harlem
maria_anna_of_spain	children	mariana_of_austria
jim_constable	gender	male
frances_folsom_cleveland	gender	female
georg_iii_duke_of_saxe_meiningen	children	regina_crown_princess_of_austria
mai_zetterling	profession	film_director
edward_higham	gender	male
edward_terry_sanford	place_of_birth	knoxville
ivojin_pavlovic	gender	male
ledi_sayadaw	gender	male
prentiss_m_brown	location	michigan
franz_grillparzer	location	vienna
dudley_moore	profession	composer
william_higinbotham	institution	williams_college
ben_hogan	location	fort_worth
david_sarnoff	place_of_birth	minsk
teoberto_maler	place_of_death	merida
friedrich_daniel_bassermann	nationality	germany
hieronymus_bock	gender	male
noel_delfosse	gender	male
peter_john_locke_king	institution	trinity_college_cambridge
roger_brooke_taney	place_of_death	washington_united_states
hermann_einstein	place_of_death	milan_italy
abdul_hasan_asaf_khan	children	mumtaz_mahal
alexander_o_anderson	location	knoxville
bob_wilkins	gender	male
david_fairchild	gender	male
gerald_ford	gender	male
constantine_p_cavafy	gender	male
johann_georg_faust	profession	astrologer
eleanor_of_aquitaine	children	richard_i_of_england
ignaz_wechselmann	nationality	hungary
pir_sultan_abdal	profession	singer
alice_cogswell	gender	female
johann_christian_rosenmuller	nationality	germany
stephen_heller	place_of_death	paris
robert_napier_1st_baron_napier_of_magdala	place_of_birth	sri_lanka
chikabo_kumada	profession	author
jorg_immendorff	gender	male
edward_iv_of_england	parents	richard_plantagenet_3rd_duke_of_york
gertrude_stein	profession	librettist
anne_bancroft	location	fire_island
francis_hincks	gender	male
coles_bashford	gender	male
william_vincent_wallace	gender	male
wernher_von_braun	religion	lutheranism
annie_m_g_schmidt	location	amsterdam
natsume_soseki	place_of_birth	tokyo
maurice_de_hirsch	place_of_death	nove_zamky
darnell_brittingham	cause_of_death	suicide
george_stubbs	gender	male
cornel_chiriac	gender	male
samuel_wendell_williston	gender	male
david_thibodaux	institution	kansas_state_university
bram_stoker	gender	male
anna_laetitia_barbauld	gender	female
shinozaki_mamoru	place_of_birth	japan
marc_chagall	gender	male
prince_randian	place_of_birth	demerara
edward_clyde_benfold	place_of_birth	staten_island
wernher_von_braun	ethnicity	german_american
gerald_ford	institution	university_of_michigan
besha_starkman	cause_of_death	murder
domenico_cimarosa	profession	opera_composer
marie_hortense_fiquet	spouse	paul_cezanne
pinedjem_i	parents	piankh
cyril_mann	nationality	england
edward_count_palatine_of_simmern	place_of_death	paris
johannes_bohn	gender	male
amir_khusro	place_of_death	delhi
james_ii_of_england	parents	henrietta_maria_of_france
konstantinos_volanakis	gender	male
clare_boothe_luce	place_of_death	washington_united_states
denis_fonvizin	place_of_death	saint_petersburg
p_v_narasimha_rao	institution	university_of_mumbai
thomas_lincoln	children	abraham_lincoln
werner_kohlmeyer	place_of_birth	kaiserslautern
fenner_brockway_baron_brockway	location	calcutta
desire_nisard	gender	male
ferdinand_cohen_blind	nationality	germany
andre_citroen	place_of_birth	paris
william_proxmire	institution	harvard_university
mountstuart_elphinstone	profession	diplomat
penelope_blount_countess_of_devonshire	children	mountjoy_blount_1st_earl_of_newport
fitz_john_porter	place_of_death	morristown
sophia_dorothea_of_hanover	gender	female
will_geer	gender	male
horace_fairbanks	gender	male
alice_of_the_united_kingdom	spouse	louis_iv_grand_duke_of_hesse
volin	place_of_death	paris
edward_burd	gender	male
micheal_o_cleirigh	location	county_donegal
julius_axelrod	religion	atheism
charles_devens	institution	harvard_law_school
samuel_benjamin_sofer	place_of_death	bratislava
desmond_llewelyn	nationality	united_kingdom
james_madison_porter	place_of_death	easton
jakub_karol_parnas	gender	male
walter_omalley	nationality	germany
b_f_skinner	institution	hamilton_college
william_of_winchester_lord_of_lunenburg	parents	matilda_of_england_duchess_of_saxony
gloria_swanson	profession	silent_film_actress
alice_claypoole_gwynne	children	gladys_vanderbilt_szechenyi
adlai_e_stevenson	spouse	letitia_stevenson
maria_of_romania	children	prince_tomislav_of_yugoslavia
marguerite_nichols	cause_of_death	pneumonia
princess_caroline_elizabeth_of_great_britain	place_of_birth	hanover
james_dahlman	nationality	germany
elihu_yale	location	boston_massachusetts
erwin_balz	nationality	germany
daniel_petrie	cause_of_death	cancer
princess_marie_auguste_of_anhalt	nationality	germany
nat_pendleton	cause_of_death	myocardial_infarction
louise_of_hesse_darmstadt	parents	louis_ix_landgrave_of_hesse_darmstadt
steve_irwin	location	melbourne_australia
empress_k_my	spouse	emperor_shomu
dorothy_crowfoot_hodgkin	nationality	united_kingdom
claudia_jennings	place_of_birth	saint_paul
laci_peterson	place_of_birth	modesto
max_planck	gender	male
pope_sabinian	profession	pope
andrzej_szczypiorski	place_of_birth	warsaw
grand_duke_alexei_mikhailovich_of_russia	parents	olga_feodorovna_grand_duchess_of_russia
nana_sahib	gender	male
nicolaas_pieneman	place_of_death	amsterdam
henri_dorleans_duc_daumale	parents	maria_amalia_of_the_two_sicilies
eric_treacy	nationality	united_kingdom
miss_frances	cause_of_death	cardiovascular_disease
thomas_binney	gender	male
arturo_toscanini	gender	male
ed_roth	gender	male
louis_philippe_i_duke_of_orleans	parents	duc_dorleans
alfonso_xii_of_spain	children	alfonso_xiii_of_spain
gerald_goldberg	nationality	republic_of_ireland
robert_mcbeath	gender	male
roswell_s_ripley	location	south_carolina
louis_the_pious	parents	hildegard_of_savoy
friedrich_daniel_von_recklinghausen	place_of_death	strasbourg
paul_feyerabend	cause_of_death	brain_tumor
leon_trotsky	nationality	russia
camille_roqueplan	gender	female
edwin_taylor_pollock	institution	united_states_naval_academy
roberto_montenegro	location	guadalajara_jalisco
wilhelm_meyer	nationality	germany
w_t_tutte	gender	male
thales	place_of_birth	miletus
ernst_wertheim	gender	male
john_brown_francis	gender	male
kamehameha_i	children	kaahumanu_ii
george_forrest_browne	gender	male
walter_payton	location	mississippi
alexander_bogdanov	profession	economist
dovima	gender	female
john_raymond_hobbs	place_of_birth	aldershot
billy_thorpe	place_of_death	sydney
yitzchak_kaduri	gender	male
howard_wyeth	institution	syracuse_university
william_bayliss	institution	university_of_oxford
larry_gene_ashbrook	place_of_death	fort_worth
joseph_marie_jacquard	profession	inventor
jakob_rosanes	gender	male
antonio_lombardo_1458	nationality	italy
bartolomeo_montagna	place_of_birth	vicenza
michael_crichton	institution	harvard_university
vera_caspary	profession	playwright
pierre_paul_puget	place_of_birth	marseille
nubar_gulbenkian	profession	businessperson
janos_arany	gender	male
elmer_ambrose_sperry	location	cortland
pierre_tarin	gender	male
salote_tupou_iii_of_tonga	nationality	tonga
maria_white_lowell	location	cambridge_massachusetts
carl_remigius_fresenius	place_of_death	wiesbaden
hannelore_kohl	cause_of_death	drug_overdose
pim_fortuyn	institution	vrije_universiteit
michael_c_kerr	gender	male
friedrich_glauser	profession	novelist
alfred_fowler	place_of_birth	yorkshire
aruj	profession	sailor
jean_bullant	gender	male
ernest_samuels	gender	male
joseph_anton_von_maffei	location	munich
vola_vale	cause_of_death	diabetes_mellitus
italo_balbo	gender	male
emperor_kobun	spouse	emperor_temmu
henry_iv_of_castile	place_of_death	madrid
maria_amalia_of_the_two_sicilies	children	louis_duke_of_nemours
erika_mann	nationality	germany
sophia_dorothea_of_hanover	location	hanover
armistead_thomson_mason	parents	stevens_thomson_mason
anton_lehar	place_of_death	vienna
gunnery_sergeant_john_e_mullin	children	infant_mullen
hugh_algernon_weddell	place_of_death	poitiers
george_back	gender	male
wilton_lockwood	gender	male
paul_azais	gender	male
jose_antonio_aguirre	gender	male
jan_fyt	gender	male
ugo_frigerio	gender	male
jack_straus	gender	male
cecco_dascoli	place_of_birth	ascoli_piceno
domenico_fontana	gender	male
screaming_lord_sutch	profession	musician
ernst_ludwig_i_duke_of_saxe_meiningen	children	ernst_ludwig_ii_duke_of_saxe_meiningen
augusta_victoria_of_hohenzollern_sigmaringen	parents	princess_maria_teresa_of_bourbon_two_sicilies
prince_tomislav_of_yugoslavia	parents	maria_of_romania
julien_green	profession	novelist
richard_iii_of_england	parents	richard_plantagenet_3rd_duke_of_york
william_r_ellis	gender	male
jusuf_prazina	place_of_birth	sarajevo
luigi_boccherini	profession	cellist
john_facenda	profession	sportscaster
e_e_smith	profession	novelist
john_a_gronouski	gender	male
ida_aalberg	gender	female
benjamin_hardin_helm	place_of_birth	bardstown
albert_iii_duke_of_bavaria	gender	male
han_van_meegeren	place_of_death	amsterdam
terry_nation	place_of_birth	cardiff
edward_count_palatine_of_simmern	nationality	germany
franz_anton_bustelli	place_of_birth	locarno
david_norvell_walker_grant	location	virginia
lee_van_cleef	gender	male
lynne_carver	place_of_birth	birmingham_alabama
tobias_bamberg	place_of_birth	holland
george_salmon	place_of_birth	dublin
karl_william_kapp	nationality	germany
raul_leoni	religion	roman_catholic_church
thomas_boleyn_1st_earl_of_wiltshire	children	mary_boleyn
steven_reuther	place_of_birth	st_petersburg
daniel_d_bruce	location	indiana
alexei_gorokhov	gender	male
robert_rowand_anderson	place_of_birth	forres
luis_t_romero	profession	guitarist
rudolf_wegscheider	place_of_death	vienna
caroline_bonaparte	spouse	joachim_murat
inazuma_raigor	gender	male
grand_duke_peter_nicolaievich_of_russia	spouse	milica_of_montenegro
william_somervile	institution	winchester_college
jean_rodolphe_perronet	profession	structural_engineer
kyoka_izumi	nationality	japan
william_brewster	gender	male
yeshayahu_leibowitz	nationality	israel
marjorie_merriweather_post	profession	socialite
sadeq_chubak	gender	male
ithiel_town	place_of_death	new_haven
johan_de_witt	religion	dutch_reformed_church
chuck_jones	profession	film_director
edward_j_debartolo_sr	profession	businessperson
henry_rutgers	gender	male
ry_sei_kishida	nationality	japan
oliver_wendell_holmes_sr	parents	abiel_holmes
arseny_tarkovsky	place_of_birth	kirovohrad
joaquin_murrieta	religion	roman_catholic_church
william_henry_flower	location	stratford-upon-avon
maria_jane_dyer	gender	female
sarah_childress_polk	spouse	james_k_polk
dean_reed	location	buenos_aires
bart_de_graaff	location	haarlem
erwin_reichel	place_of_birth	vienna
paul_verlaine	place_of_birth	metz
robert_oppenheimer	institution	harvard_university
lady_bird_johnson	spouse	lyndon_b_johnson
antoni_clave	profession	production_designer
anne_of_york	place_of_birth	palace_of_westminster
archie_campbell	place_of_death	knoxville
lucien_e_blackwell	ethnicity	african_american
birendra_of_nepal	parents	mahendra_of_nepal
peter_meaden	profession	talent_manager
david_devdariani	cause_of_death	cancer
pierre-simon_laplace	gender	male
thomas_tongue	gender	male
pietro_psaier	place_of_death	sri_lanka
may_whitty	cause_of_death	cancer
anton_von_schmerling	location	vienna
sun_yat-sen	spouse	lu_muzhen
i_l_patterson	cause_of_death	pneumonia
henry_schoolcraft	location	albany
arkady_raikin	location	latvia
james_h_kyle	place_of_death	aberdeen_south_dakota
harukichi_hyakutake	gender	male
friedrich_nietzsche	gender	male
patrick_cardinal_odonnell	location	county_donegal
siegfried_einstein	nationality	germany
kirill_mazurov	ethnicity	belarusians
torbern_bergman	nationality	sweden
archduchess_gisela_of_austria	parents	franz_joseph_i_of_austria
arnold_van_keppel_1st_earl_of_albemarle	nationality	dutch_republic
george_gamow	profession	astronomer
pedro_of_castile	location	tordesillas
barry_sadler	gender	male
p_g_wodehouse	gender	male
james_britten	location	high_wycombe
fabian_odea	gender	male
wander_johannes_de_haas	location	south_holland
karl_gordon_henize	place_of_birth	cincinnati_ohio
james_w_tate	spouse	clarice_mayne
maximilian_ii_holy_roman_emperor	parents	ferdinand_i_holy_roman_emperor
lyudmila_pavlichenko	gender	female
cyrus_hermann_kotzschmar_curtis	place_of_birth	portland_maine
giuseppe_moretti	location	siena
alfred_lion	religion	judaism
george_spencer_churchill_5th_duke_of_marlborough	place_of_death	blenheim_palace
elisabeth_of_bavaria	religion	roman_catholic_church
ralph_greene	ethnicity	african_american
ivy_compton-burnett	gender	female
jack_clayton	gender	male
june_allyson	spouse	dick_powell
albert_spencer_7th_earl_spencer	institution	trinity_college_cambridge
james_coburn	cause_of_death	myocardial_infarction
charles_spencer_churchill_9th_duke_of_marlborough	nationality	united_kingdom
charlie_bradberry	gender	male
andrew_taylor_still	location	kirksville
kim_il-sung	place_of_death	pyongyang
joel_pettersson	gender	male
webb_hayes	location	ohio
jean-victor_poncelet	place_of_birth	metz
wladyslaw_szafer	nationality	poland
clark_g_reynolds	gender	male
sivanath_sastri	place_of_death	calcutta
fritz_pfleumer	nationality	germany
rashid_rauf	nationality	united_kingdom
henry_stephens_salt	nationality	england
eva-maria_buch	nationality	germany
francesco_de_layolle	nationality	italy
rudolf_iv_duke_of_austria	parents	albert_ii_duke_of_austria
karl_denke	profession	serial_killer
anton_bernolak	profession	priest
wolfgang_lotz	place_of_death	munich
joseph_bonaparte	place_of_death	florence
wilhelm_pieck	nationality	germany
berke	parents	jochi
joseph_c_rodriguez	ethnicity	mexican_american
ignacy_zaborowski	gender	male
qian_zhongshu	institution	university_of_oxford
bobby_byrd	profession	musician
otto_ii_van_lippe	nationality	germany
john_tower	place_of_death	brunswick
james_n_gray	gender	male
heinrich_sylvester_theodor_tiling	nationality	germany
olga_georges_picot	place_of_death	paris
mikhail_shcherbatov	gender	male
george_dayton	cause_of_death	cancer
edward_m_davis	children	william_morris_davis
clifford_geertz	institution	antioch_college
edward_j_debartolo_sr	place_of_birth	youngstown
william_merritt_chase	gender	male
antonio_salieri	profession	composer
thilo_irmisch	gender	male
billy_rogell	gender	male
sun_yat-sen	spouse	soong_ching-ling
clyde_m_reed	religion	methodism
joseph_h_acklen	gender	male
george_gamow	nationality	russia
marta_abba	gender	female
charles_abbot_1st_baron_colchester	institution	westminster_school
michael_c_kerr	location	indiana
frederick_corbett	gender	male
emile_littre	place_of_birth	paris
amelia_opie	nationality	england
merton_miller	institution	johns_hopkins_university
smiley_burnette	cause_of_death	leukemia
eileen_lonergan	gender	female
albrecht_durer	nationality	germany
ludvig_holberg	gender	male
heinrich_christian_boie	profession	journalist
constanze_mozart	place_of_birth	zell_im_wiesental
raoul_bott	nationality	hungary
andrea_del_verrocchio	place_of_birth	florence
anna_deste	place_of_death	paris
norma_talmadge	spouse	george_jessel
elizabeth_jolley	place_of_death	perth
charles_de_geer	nationality	sweden
hermann_abert	institution	university_of_leipzig
renee_of_france	parents	louis_xii_of_france
nathuram_godse	cause_of_death	capital_punishment
leslie_stephen	institution	kings_college_london
brooke_astor	place_of_birth	portsmouth_new_hampshire
william_chatterton_dix	gender	male
robert_mylne	gender	male
philippe_leotard	place_of_death	paris
christopher_paudiss	nationality	germany
simon_sechter	place_of_death	vienna
johnny_cymbal_ochiltree	place_of_death	nashville_tennessee
maurice_de_hirsch	place_of_birth	munich
carmine_tramunti	gender	male
emile_jaques-dalcroze	place_of_birth	vienna
faust_vrancic	place_of_death	venice
henry_watson_fowler	profession	lexicographer
tsarevich_dimitri	parents	ivan_iv_of_russia
jimmie_adams	cause_of_death	myocardial_infarction
milo_obrenovic_i_prince_of_serbia	children	milan_obrenovic_ii_prince_of_serbia
rob_moroso	gender	male
syd_thrift	cause_of_death	surgical_complications
sakamoto_ryoma	place_of_birth	kochi_japan
paul_ehrlich	nationality	germany
ed_roth	religion	church_of_jesus_christ_of_latter-day_saints
marie_amalie_of_austria	gender	female
joseph_carter_abbott	location	boston_massachusetts
mark_rothko	cause_of_death	suicide
john_dunjee	ethnicity	african_american
camille_pissarro	place_of_birth	charlotte_amalie
john_crosland	nationality	england
heinrich_zschokke	place_of_birth	magdeburg
tintoretto	place_of_birth	venice
samson_raphaelson	gender	male
vladimir_vernadsky	location	russian_empire
john_raymond_hobbs	gender	male
henry_way_kendall	institution	massachusetts_institute_of_technology
caroline_of_brunswick	parents	charles_william_ferdinand_duke_of_brunswick
victor_borge	nationality	denmark
amalie_adlerberg	gender	female
john_wayne_gacy	profession	clown
raul_leoni	gender	male
peter_jones_1802	location	burlington_ontario
mr_s_hiritzo	gender	male
thomas_huxley	gender	male
j_d_bernal	nationality	republic_of_ireland
georges_tanguay	place_of_birth	quebec_city
uchimura_kanzo	location	tokyo
josephus_daniels	place_of_birth	washington_north_carolina
austin_flint	gender	male
eleonore_desmier_dolbreuse	children	sophia_dorothea_of_celle
charles_stanley_1819	gender	male
herbert_muschamp	institution	university_of_pennsylvania
jean-jacques_rousseau	place_of_birth	geneva
andreyan_zakharov	place_of_birth	saint_petersburg
alfred_w_benson	location	buffalo
adam_smith	institution	university_of_glasgow
krim_belkacem	cause_of_death	assassination
cajetan_freiherr_von_felder	place_of_birth	vienna
giambattista_bodoni	place_of_death	parma
juan_de_arellano	nationality	spain
james_m_mead	place_of_death	lakeland
hugh_edwin_strickland	nationality	united_kingdom
zoltan_tildy	nationality	hungary
nikolaus_lenau	nationality	austria
johan_christian_heuch	gender	male
john_wayne_gacy	location	waterloo
harry_strauss	cause_of_death	capital_punishment
william_george_penney	institution	university_of_london
fazil_husnu_da_larca	place_of_death	istanbul
louis_iv_grand_duke_of_hesse	children	princess_victoria_of_hesse_and_by_rhine
jean_gilbert	gender	male
pope_alexander_iv	gender	male
gabriel-elzear_taschereau	profession	judge
franz_werfel	religion	judaism
harold_sonny_ladoo	profession	novelist
william_backhouse_astor_jr	cause_of_death	myocardial_infarction
emile_chartier	place_of_death	le_vesinet
robert_strausz-hupe	gender	male
adolf_frederick_i_duke_of_mecklenburg_schwerin	children	adolf_frederick_ii_duke_of_mecklenburg_strelitz
malcolm_wilson_1914	religion	roman_catholic_church
brigham_young	religion	mormonism
jacques_riviere	profession	novelist
michael_hatton	location	sydney
andrew_moore	place_of_death	lexington_city
heinrich_christian_schumacher	nationality	germany
russ_conway	profession	musician
henry_i_of_france	children	philip_i_of_france
alexandra_fyodorovna_of_hesse	religion	lutheranism
bouloussou_soubramanion_sastroulou	religion	hindu
vittorio_gassman	ethnicity	italian_people
gunther_von_kluge	place_of_death	metz
george_copway	gender	male
jo_jo_laine	profession	singer
rembrandt_peale	place_of_death	philadelphia
patrick_troughton	gender	male
andre_le_notre	gender	male
charlotte_charke	nationality	england
nadezhda_konstantinovna_krupskaya	gender	female
edward_keliiahonui	place_of_death	honolulu
phillip_c_katz	place_of_death	san_francisco
nadar	gender	male
pierre_varignon	place_of_death	paris
charles_francis_adams_iii	parents	charles_francis_adams_jr
mark_lombardi	institution	syracuse_university
john_george_ii_elector_of_saxony	children	john_george_iii_elector_of_saxony
anthony_quinn	gender	male
isaac_asimov	ethnicity	russian_american
burnet_r_maybank	place_of_birth	charleston
john_maynard_keynes	nationality	england
edouard_dujardin	gender	male
stanley_kunitz	ethnicity	american_jews
alessandro_specchi	profession	architect
john_m_ashbrook	place_of_death	johnstown_ohio
hans_fischer	place_of_death	munich
rajendra_chola_i	gender	male
victoria_of_the_united_kingdom	children	alice_of_the_united_kingdom
mario_montessori_sr	parents	maria_montessori
richard_of_shrewsbury_1st_duke_of_york	location	ludlow_castle
emily_remler	place_of_death	sydney
gilbert_de_clare_5th_earl_of_hertford	gender	male
mykolas_birziska	gender	male
heinrich_gontermann	gender	male
may_swenson	religion	church_of_jesus_christ_of_latter-day_saints
sherwood_anderson	gender	male
karl_schnaase	place_of_death	wiesbaden
tiny_tim_1932	gender	male
felix_draeseke	place_of_death	dresden
willem_van_aelst	gender	male
anita_louise	gender	female
philip_thicknesse	gender	male
george_hamilton_gordon_4th_earl_of_aberdeen	location	stanmore
eleanor_stewart_princess_of_scotland	place_of_death	innsbruck
vola_vale	gender	female
dwight_d_eisenhower	location	texas
grand_duke_michael_pavlovich_of_russia	place_of_death	warsaw
princess_helena_duchess_of_albany	children	carl_eduard_duke_of_saxe_coburg_and_gotha
tiradentes	gender	male
gertrude_denman	nationality	united_kingdom
pamela_harriman	cause_of_death	stroke
tatsuhiko_shibusawa	cause_of_death	cancer
laurie_nash	location	tasmania
arnold_janssen	place_of_death	holland
al_sanders	place_of_birth	st_louis_missouri
lavrentiy_beria	religion	atheism
hiram_price	location	davenport
egon_erwin_kisch	nationality	austria
jeff_porcaro	location	hartford_connecticut
richard_august_carl_emil_erlenmeyer	institution	university_of_giessen
osman_iii	parents	mustafa_ii
nefertiti	children	tutankhamun
tomas_masaryk	profession	sociologist
david_thibodaux	religion	roman_catholic_church
sam_walton	location	arkansas
saovabha	gender	female
dudley_moore	profession	jazz_pianist
al_parker	gender	male
prince_gustav_adolf_duke_of_vasterbotten	parents	princess_margaret_of_connaught
george_victor_prince_of_waldeck_and_pyrmont	children	princess_helena_duchess_of_albany
edward_calvin_kendall	gender	male
saint_kilian	place_of_death	wurzburg
karl_brugmann	gender	male
anastasio_somoza_debayle	cause_of_death	assassination
prince_arthur_duke_of_connaught_and_strathearn	parents	victoria_of_the_united_kingdom
alexandrine_of_mecklenburg-schwerin	location	mecklenburg-schwerin
cornelius_jansen	location	gelderland
joseph_bonaparte	parents	letizia_ramolino
benjamin_h_vandervoort	gender	male
hans_sloane	gender	male
adolf_cardinal_bertram	place_of_birth	hildesheim
ludwig_salvator	gender	male
mona_fandey	cause_of_death	capital_punishment
adolf_brand	gender	male
the_notorious_big	profession	record_producer
francisco_guerrero	nationality	spain
mette_marit_crown_princess_of_norway	location	kristiansand
maria_luisa_bemberg	place_of_death	buenos_aires
stanley_ketchel	cause_of_death	gunshot
gilbert_harding	profession	disc_jockey
ludwig_lachmann	nationality	united_kingdom
saint_fermin	gender	male
leopold_steinbatz	location	vienna
jan_van_dommelen	place_of_birth	amsterdam
mike_oxley	place_of_birth	findlay
james_franck	place_of_birth	hamburg
max_brod	nationality	austria
wilhelmine_von_sagan	place_of_death	vienna
anton_von_schmerling	place_of_birth	vienna
mahadevi_varma	location	allahabad
john_tartaglione	nationality	italy
lavrentiy_beria	gender	male
philip_chetwode_1st_baron_chetwode	place_of_birth	westminster
james_h_hawley	place_of_death	boise
franz_danzi	nationality	germany
thomas_harper_ince	gender	male
kurt_schwitters	gender	male
charlotte_dacre	profession	poet
andre_kertesz	religion	judaism
vasily_bartold	location	saint_petersburg
charles_ii_gonzaga	children	eleanor_of_mantua_empress_ferdinand_iii
luis_de_la_fuente	location	veracruz
richard_iii_of_england	spouse	anne_neville
ramon_sampedro	gender	male
walter_a_haas_jr	institution	harvard_business_school
kenneth_thomson_2nd_baron_thomson_of_fleet	gender	male
michael_pedersen_friis	place_of_death	copenhagen
john_andrew_la_nauze	gender	male
marguerite_louise_dorleans	location	centre_france
maria_fyodorovna_of_russia	children	grand_duke_michael_pavlovich_of_russia
steve_van_dorpel	gender	male
touch_the_clouds	parents	lone_horn
tilly_losch	nationality	austria
roy_wood	profession	composer
john_cromwell	profession	film_director
makhan_lal_chaturvedi	nationality	india
alvan_clark	children	george_bassett_clark
tadamichi_kuribayashi	gender	male
ferdinand_ii_of_aragon	children	joanna_of_castile
pyrrhus_of_epirus	children	alexander_ii_of_epirus
joseph_whitworth	nationality	england
antonio_da_correggio	place_of_birth	correggio
rudger_clawson	location	salt_lake_city
bill_bixby	institution	city_college_of_san_francisco
jules_paul_benjamin_delessert	profession	botanist
calvin_l_rampton	place_of_death	holladay
art_carney	gender	male
pierre_cauchon	place_of_birth	reims
walter_payton	location	barrington
werner_von_gilsa	gender	male
johnny_cash	gender	male
erich_barenfanger	cause_of_death	suicide
moses_sofer	ethnicity	germans
jacqueline_du_pre	religion	judaism
maria_annunciata_of_the_two_sicilies	children	archduke_ferdinand_karl_of_austria
huseyin_hilmi_pasha	nationality	turkey
jasimuddin	location	dhaka
will_lee	gender	male
adelaide_hall	profession	singer
robert_pete_williams	profession	guitarist
eric_coates	location	hucknall
ellen_sharples	nationality	kingdom_of_great_britain
peter_iii_of_russia	parents	anna_petrovna_of_russia
edward_calvin_kendall	place_of_death	princeton
pedro_of_castile	parents	alfonso_xi_of_castile
guy_tachard	religion	roman_catholic_church
star_stowe	gender	female
joseph_smith_harris	profession	surveying
giambologna	nationality	italy
ruben_salazar	place_of_birth	ciudad_juarez
handel_cossham	nationality	united_kingdom
nathaniel_wyeth	gender	male
goparaju_ramachandra_rao	gender	male
gustav_holst	nationality	england
joseph_szigeti	nationality	hungary
marcelo_fromer	gender	male
emperor_temmu	spouse	emperor_kobun
artemisia_gentileschi	parents	orazio_gentileschi
samuel_wendell_williston	place_of_birth	boston_massachusetts
kiichi_aichi	gender	male
alfred_friedrich_bluntschli	gender	male
marcus_vipsanius_agrippa	children	agrippina_the_elder
vincent_astor	profession	publishing
william_few	gender	male
alfred_deakin	religion	spiritualism
sam_walton	cause_of_death	multiple_myeloma
john_hawkes	location	stamford
john_edward_brownlee	place_of_death	calgary_alberta
alfie_bass	gender	male
anthony_ogrady_lefroy	gender	male
mike_gonzalez	gender	male
max_cetto	place_of_birth	koblenz
lothair_ii_of_lotharingia	gender	male
wolfgang_pauli	location	vienna
benjamin_m_miller	institution	university_of_alabama
infant_mullen	cause_of_death	severe_trauma
chalino_sanchez	gender	male
richard_august_carl_emil_erlenmeyer	nationality	germany
charlotte_burton	gender	female
william_j_florence	gender	male
william_proxmire	location	lake_forest
konrad_adenauer	gender	male
grand_duke_peter_nicolaievich_of_russia	children	prince_roman_petrovich_of_russia
james_brown	profession	organist
philip_v_of_spain	place_of_birth	versailles
isaac_asimov	religion	atheism
john_f_shafroth	gender	male
teo_macero	institution	juilliard_school
john_gould_fletcher	institution	harvard_university
ibn_arabi	gender	male
menachem_begin	nationality	israel
john_thynne_4th_marquess_of_bath	nationality	united_kingdom
johann_christian_bach	religion	roman_catholic_church
martin_augustine_knapp	place_of_death	washington_united_states
george_alfred_carlson	place_of_death	denver
daniel_read	gender	male
barbara_woodhouse	gender	female
piankh	children	pinedjem_i
jeremiah_duggan	place_of_death	wiesbaden
william_kunstler	cause_of_death	cardiovascular_disease
william_woodbridge	gender	male
dick_daugherty	profession	american_football_player
pamela_harriman	religion	roman_catholic_church
conrad_gessner	place_of_death	zurich
william_wordsworth	place_of_death	ambleside
aleardo_aleardi	nationality	italy
gotthold_ephraim_lessing	profession	art_critic
lana_turner	gender	female
bob_crane	location	waterbury
carl_ferdinand_cori	place_of_death	cambridge_massachusetts
leo_breiman	profession	statistician
dutta_samant	nationality	india
roger_brooke_taney	profession	judge
gilbert_frankau	religion	judaism
gilbert_harding	profession	journalist
paola_borboni	place_of_birth	emilia-romagna
daniel_woodson	place_of_birth	albemarle_county
zoe_tamerlis_lund	cause_of_death	drug_overdose
jessie_macwilliams	institution	harvard_university
margaret_caroline_anderson	location	indianapolis
te_rangi_hiroa	gender	male
enid_yandell	gender	female
jane_barbe	place_of_death	roswell_georgia
harry_beaumont	gender	male
catherine_trotter_cockburn	profession	poet
james_h_snook	gender	male
roy_wood	nationality	england
george_taylor	place_of_death	easton
marie_amalie_of_austria	place_of_birth	vienna
sneaky_pete_kleinow	profession	musician
gertrude_vachon	gender	female
georg_johannesen	place_of_death	egypt
charles_abbot_1st_baron_colchester	nationality	united_kingdom
james_a_campbell	location	youngstown
hampden_coit_dubose	location	south_carolina
hal_smith_1916	profession	voice_acting
andres_bonifacio	gender	male
john_woodroffe	profession	judge
sophie_charlotte_ackermann	place_of_death	hamburg
yoshijiro_umezu	place_of_death	tokyo
anna_keaveney	cause_of_death	lung_cancer
augustus_montague_toplady	nationality	england
saunders_mac_lane	place_of_death	san_francisco
karl_ferdinand_sohn	nationality	germany
marty_hogan	place_of_birth	wednesbury
leonardo_fibonacci	religion	catholic
john_mccourt	profession	judge
nancy_dickerson	institution	the_catholic_university_of_america
samuel_johnston	gender	male
conny_plank	gender	male
nancy_dickerson	gender	female
jules_de_trooz	place_of_birth	leuven
tony_wilson	institution	bachelor_of_arts
charles_h_crane	place_of_birth	newport_rhode_island
theodore_thurston_geer	institution	willamette_university
izumi_sakai	profession	singer
betty_holberton	place_of_birth	philadelphia
alexander_h_rice_jr	place_of_death	newport_rhode_island
ossie_davis	gender	male
ettie_annie_rout	location	tasmania
william_henry_harrison	religion	episcopal_church_in_the_united_states_of_america
madhubala	location	delhi
dinteville	gender	male
pierpont_edwards	gender	male
leon_greenman	gender	male
clement_claiborne_clay	institution	university_of_virginia
otto_hermann_kahn	nationality	england
joseph_a_mower	gender	male
desiree_clary	place_of_death	stockholm
james_kitson_1st_baron_airedale	nationality	united_kingdom
sammy_woods	place_of_death	taunton
william_rehnquist	religion	lutheranism
frederic_brooks_dugdale	place_of_death	gloucestershire
nicole_brown_simpson	location	laguna_beach
william_r_day	gender	male
ole_worm	place_of_birth	aarhus
rose_fitzgerald_kennedy	location	boston_massachusetts
gilbert_harding	gender	male
edward_raczynski	place_of_birth	zakopane
p_t_barnum	profession	businessperson
janos_flesch	gender	male
donna_reed	gender	male
roddy_mcdowall	cause_of_death	lung_cancer
maximilian_ii_holy_roman_emperor	profession	holy_roman_emperor
robert_stevenson_1905	nationality	england
homer_h_norton	gender	male
hanns_martin_schleyer	gender	male
mary_tudor	place_of_birth	richmond_palace
bartholomaeus_pitiscus	gender	male
judah_touro	profession	businessperson
patrick_troughton	place_of_death	columbus_georgia
ramesses_iii	cause_of_death	assassination
walter_sickert	place_of_birth	munich
john_williams_1778	gender	male
tsuru_aoki	place_of_death	tokyo
justin_strzelczyk	location	buffalo
charles_k_graham	gender	male
friedrich_nietzsche	nationality	germany
j_r_clifford	gender	male
joshua_nkomo	place_of_birth	southern_rhodesia
lech_kaczynski	nationality	poland
vincent_astor	gender	male
teo_macero	profession	record_producer
armand_beauvais	gender	male
edward_hincks	gender	male
john_i_beggs	profession	business_magnate
marina_berti	gender	female
david_hoggan	gender	male
nancy_carroll	gender	female
prince_arthur_duke_of_connaught_and_strathearn	children	princess_margaret_of_connaught
sigurd_lewerentz	profession	architect
ramon_emeterio_betances	gender	male
jorge_negrete	profession	singer
sammy_woods	location	sydney
francis_willughby	gender	male
tutankhamun	place_of_birth	ancient_egypt
jo_ann_davis	location	virginia
max_baer	gender	male
john_rabe	gender	male
paul_avrich	gender	male
john_scott_russell	institution	university_of_edinburgh
hildegard_of_savoy	spouse	charlemagne
alfonso_vii_of_leon	children	constance_of_castile_queen_of_france
stephen_mallory	children	stephen_mallory_ii
georg_friedrich_creuzer	gender	male
thierry_aubin	gender	male
daniel_emilfork	gender	male
michael_iii	parents	theophilos
etta_baker	ethnicity	african_american
tomas_macgiolla	place_of_death	dublin
frederick_i_margrave_of_brandenburg-ansbach	children	casimir_margrave_of_brandenburg_bayreuth
amenhotep_iii	spouse	tiye
alexander_iv_of_macedon	parents	alexander_the_great
willem_boy	gender	male
serge_reggiani	cause_of_death	myocardial_infarction
john_alexander_forrest	institution	university_of_aberdeen
reuben_goodstein	gender	male
thomas_stanley_matthews	place_of_birth	cincinnati_ohio
petr_bezruc	place_of_death	olomouc
john_carroll_1891	location	brisbane
john_m_ford	location	east_chicago
william_grant_still	location	arkansas
zack_james_bellar	parents	wendy_rene_bellar
joseph_bonaparte	children	zenaide_laetitia_julie_bonaparte
cesar-francois_cassini_de_thury	gender	male
sergei_lyapunov	place_of_death	paris
armand_kaliz	cause_of_death	myocardial_infarction
matthias_sindelar	nationality	austria
john_galen_howard	place_of_death	san_francisco
john_lubbock_1st_baron_avebury	gender	male
sugar_ray_robinson	cause_of_death	diabetes_mellitus
federico_luigi_conte_menabrea	place_of_birth	chambery
ben_hogan	place_of_death	fort_worth
antoine_lacroix	location	bourgogne
pedro_de_alcantara_tellez_giron_9th_duke_of_osuna	spouse	maria_josefa_de_la_soledad_9th_duchess_of_osuna
patrick_forbes	place_of_death	aberdeen
karoly_huszar	place_of_death	budapest
johann_georg_chevalier_de_saxe	parents	augustus_ii_the_strong
clarence_birdseye	profession	inventor
vincent_astor	parents	john_jacob_astor_iv
karl_otto_koch	nationality	germany
maurice_adler	spouse	anita_louise
gene_hickerson	gender	male
julius_von_sachs	location	wroclaw
kirill_mazurov	nationality	russia
bee_ho_gray	gender	male
margaret_ball	religion	roman_catholic_church
albert_mosse	nationality	germany
sherrod_e_skinner_jr	gender	male
claude_hudson	gender	male
peter_finch	nationality	united_kingdom
david_niven	nationality	england
bibb_graves	place_of_death	sarasota
william_cholmondeley_3rd_marquess_of_cholmondeley	parents	george_cholmondeley_1st_marquess_of_cholmondeley
w_e_w_petter	gender	male
terence_young	gender	male
edward_iv_of_england	children	richard_of_shrewsbury_1st_duke_of_york
r_m_lockley	gender	male
charley_chase	cause_of_death	myocardial_infarction
johnny_sain	cause_of_death	stroke
thea_rasche	gender	female
cesar-francois_cassini_de_thury	place_of_death	paris
tommy_trinder	gender	male
mississippi_fred_mcdowell	ethnicity	african_american
edgar_wilson	location	boise
george_lewis_gillespie_jr	location	tennessee
jose_angel_lamas	place_of_birth	caracas
herbert_henry_dow	institution	case_western_reserve_university
william_le_lacheur	gender	male
elizabeth_clinton_countess_of_lincoln	religion	roman_catholic_church
thomas_colclough_watson	gender	male
anne_of_york	nationality	england
salimuzzaman_siddiqui	location	lucknow
willie_nile	profession	guitarist
betty_holberton	gender	female
giovanni_cardinal_de_medici	gender	male
oscar_k_allen	location	louisiana
william_t_h_brooks	gender	male
james_henry_dickey_henderson	location	eugene_oregon
walter_omalley	institution	university_of_pennsylvania
benjamin_outram	gender	male
kamehameha_i	spouse	keopuolani
rowland_frazee	institution	dalhousie_university
ebenezer_r_hoar	children	sherman_hoar
h_c_artmann	gender	male
ivan_vi_of_russia	cause_of_death	assassination
eugene_lanceray	gender	male
juan_cailles	gender	male
paul_johann_ludwig_von_heyse	profession	novelist
sancha_of_castile	spouse	alfonso_ii_of_aragon
albert_spencer_7th_earl_spencer	parents	charles_spencer_6th_earl_spencer
frederick_viii_of_denmark	children	princess_louise_of_denmark
james_madison	parents	james_madison_sr
hugh_paddick	place_of_birth	hoddesdon
joseph_francis_shea	place_of_birth	the_bronx
ernst_von_koerber	location	trento
andre_eglevsky	gender	male
scott_beach	gender	male
elijah_ward	gender	male
william_alabaster	institution	trinity_college_cambridge
alfonso_xiii_of_spain	location	madrid
marjorie_daw	spouse	a_edward_sutherland
tony_wilson	gender	male
ludvik_kuba	gender	male
james_carlile	place_of_death	dublin
alexandr_griboyedov	nationality	russia
kenneth_hahn	gender	male
felicia_hemans	location	liverpool
yma_sumac	nationality	peru
james_kitson_1st_baron_airedale	gender	male
albert_ii_duke_of_austria	parents	elisabeth_of_tirol
thurman_munson	place_of_birth	akron
george_adamson	spouse	joy_adamson
hodding_carter	gender	male
ruth_berlau	place_of_death	east_berlin
svend_methling	place_of_birth	denmark
bradley_palmer	gender	male
kubota_mantaro	gender	male
garry_moore	location	baltimore
yongzheng_emperor	spouse	empress_xiaojing
felipe_prospero_of_habsburg	parents	mariana_of_austria
herman_talmadge	institution	university_of_georgia
rudolph_dirks	gender	male
wayman_tisdale	profession	musician
albert_ritter_conti_v_cedassamare	gender	male
nathaniel_bowditch	place_of_birth	salem_massachusetts
vasily_golovnin	gender	male
juan_de_arellano	location	madrid
lucy_stone	children	alice_stone_blackwell
michel_marie_charles_verlat	nationality	belgium
g_k_chesterton	profession	novelist
william_dean_howells	profession	novelist
ramesses_iii	children	ramesses_iv
louis_c_wyman	profession	judge
graham_greene	gender	male
james_breckinridge	gender	male
adalbert_of_egmond	gender	male
peter_diamond	place_of_birth	united_kingdom
maria_annunciata_of_the_two_sicilies	children	archduke_franz_ferdinand_of_austria
edmond_de_selys_longchamps	nationality	belgium
zden_k_podskalsky	nationality	czechoslovakia
alfred_north_whitehead	institution	trinity_college_cambridge
auguste_francois_biard	place_of_death	fontainebleau
john_henry_wright	place_of_death	cambridge_massachusetts
philip_iv_of_france	children	isabella_of_france
ernst_ludwig_ii_duke_of_saxe_meiningen	parents	ernst_ludwig_i_duke_of_saxe_meiningen
samuel_platt	place_of_birth	armagh
joan_lowell	profession	author
thomas_j_ryan_new_orleans	gender	male
charles_goodnight	location	illinois
archie_campbell	profession	musician
antoinette_brown	religion	congregational_church
samuel_chase	place_of_birth	somerset_county_maryland
nicholas_i_of_montenegro	parents	prince_michael_of_montenegro
emil_fahrenkamp	gender	male
roy_o_disney	gender	male
princess_elisabeth_of_saxe-altenburg	gender	female
ralph_allen	nationality	united_kingdom
rick_danko	profession	guitarist
philip_ii_of_spain	children	caterina_micaela_of_spain
joseph_mathaus_aigner	place_of_death	vienna
alessandro_specchi	gender	male
peter_i_of_russia	gender	male
leopold_von_schrotter	nationality	austria
paul_poiret	place_of_birth	paris
ammianus_marcellinus	religion	paganism
ryan_patrick_halligan	gender	male
james_iredell_waddell	gender	male
karl_ludwig_von_phull	place_of_birth	ludwigsburg
rai_rajeshwar	nationality	india
bruce_w_carter	place_of_birth	schenectady
john_chancellor	place_of_death	princeton
betsy_jones-moreland	gender	female
william_henry_lee	place_of_birth	trois_rivieres_quebec
natalia_sedova	spouse	leon_trotsky
harry_strauss	gender	male
william_h_milliken_jr	gender	male
albrecht_becker	nationality	germany
james_m_mead	gender	male
ted_ray	gender	male
charles_eugene_lancelot_brown	place_of_birth	winterthur
johannes_plendl	gender	male
safi_al-din	gender	male
hans_van_mierlo	religion	atheism
gaetano_trentanove	nationality	italy
fred_macmurray	place_of_birth	kankakee
marie_of_baden_sponheim	nationality	germany
mountjoy_blount_1st_earl_of_newport	gender	male
edward_ii_of_england	spouse	isabella_of_france
max_verworn	gender	male
peter_i_duke_of_brittany	spouse	alix_of_thouars
charles_william_ferdinand_duke_of_brunswick	place_of_birth	wolfenbuttel
norberto_quirno_costa	location	buenos_aires
keir_hardie	gender	male
lynn_redgrave	nationality	england
r_k_narayan	place_of_death	delhi
stefan_krcmery	gender	male
mary_of_modena	spouse	james_ii_of_england
olga_valerianovna_paley	place_of_birth	saint_petersburg
thomas_w_fowler	place_of_birth	wichita_falls
lukas_foss	ethnicity	germans
matthew_arlington_batson	gender	male
prince_ludwig_of_hesse_and_by_rhine	cause_of_death	aviation_accidents_and_incidents
charles_ray_hatcher	gender	male
david_turpie	institution	kenyon_college
fahri_koruturk	gender	male
maria_anna_of_austria	place_of_birth	graz
carmen_mondragon	gender	female
george_andrew_davis_jr	location	texas
georg_hermann_quincke	nationality	germany
joanna_southcott	gender	female
alexander_s_williams	cause_of_death	death_by_natural_causes
stephen_lawrence	cause_of_death	murder
ephraim_katzir	religion	judaism
girolamo_mazzola_bedoli	gender	male
helen_allingham	nationality	england
prince_joseph_clemens_of_bavaria	location	munich
billy_thorpe	profession	record_producer
antonio_segni	gender	male
levi_woodbury	institution	litchfield_law_school
edouard_cardinal_gagnon	institution	universite_laval
cosima_wagner	location	bayreuth
atahualpa	parents	huayna_capac
john_douglas_9th_marquess_of_queensberry	children	lord_alfred_douglas
caspar_isenkrahe	nationality	germany
joseph_israel_tarte	gender	male
cecco_dascoli	place_of_death	florence
lloyd_nolan	location	san_francisco
raymond_berthiaume	cause_of_death	cancer
al_waxman	religion	judaism
francoise_athenais_marquise_de_montespan	children	louise_francoise_de_bourbon
paul_painleve	place_of_death	paris
abbas_i_of_persia	place_of_birth	herat
jack_purvis_1937	gender	male
john_flamsteed	gender	male
anna_of_bohemia_and_hungary	spouse	wilhelm_duke_of_julich_cleves_berg
philip_v_of_spain	children	maria_antonietta_of_spain
emily_mclaughlin	institution	middlebury_college
feodor_iii_of_russia	nationality	russia
leo_abse	gender	male
elisabeth_of_parma	children	louis_count_de_chinchon
neville_brand	cause_of_death	emphysema
aphra_behn	gender	female
ernst_steinitz	place_of_death	kiel
emil_petaja	location	california
albert_e_tozier	gender	male
virginia_haviland	place_of_death	washington_united_states
george_regas	spouse	reine_davies
henry_way_kendall	place_of_birth	boston_massachusetts
joseph_edamaruku	gender	male
numerian	parents	carus
hussein_bin_ali_sharif_of_mecca	religion	sunni_islam
harry_lord	gender	male
harriet_hammond	gender	female
larry_grayson	nationality	england
maximilian_ii_of_bavaria	children	otto_of_bavaria
ramon_novarro	cause_of_death	murder
alfred_bossom	nationality	england
theodor_kotsch	place_of_death	munich
ehmede_xani	nationality	kurdistan
yohannes_iv_of_ethiopia	gender	male
theodosius_i	spouse	galla
theos_casimir_bernard	spouse	ganna_walska
alcibiades	place_of_birth	athens
mieczyslaw_karlowicz	cause_of_death	skiing_accident
thomas_roberts_ferguson	gender	male
george_washington_lambert	gender	male
jan_smuts	institution	christs_college_cambridge
marian_rejewski	location	bydgoszcz
james_mason_hutchings	gender	male
kerwin_mathews	location	janesville
david_john_williams	gender	male
charles_a_beard	gender	male
elisabeth_of_austria_1554	parents	maria_of_spain
linda_lovelace	location	the_bronx
cecilia_colledge	nationality	united_kingdom
jan_gies	spouse	miep_gies
dwarkanath_ganguly	spouse	kadambini_ganguly
paul_newman	spouse	joanne_woodward
lewis_nixon_1861	profession	architect
teresa_of_the_two_sicilies	gender	female
catherine_trotter_cockburn	profession	novelist
oliver_kirk	gender	male
haji_zeynalabdin_taghiyev	gender	male
norberto_quirno_costa	place_of_death	buenos_aires
george_thesiger	nationality	united_kingdom
paul_dehn	institution	brasenose_college_oxford
tom_pettit	profession	journalist
donald_watson	place_of_birth	mexborough
ruhollah_khomeini	ethnicity	al_mosawi
camille_chamoun	gender	male
anil_moonesinghe	gender	male
jennifer_dunn	place_of_death	alexandria_virginia
henry_taylor_blow	institution	saint_louis_university
esther_ralston	place_of_death	ventura
constance_georgine_countess_markiewicz	gender	female
james_patterson_1833	nationality	australia
louis_xii_of_france	spouse	joan_of_france_duchess_of_berry
john_murray_forbes	profession	businessperson
alexander_o_anderson	place_of_death	knoxville
antoine_bourdelle	gender	male
john_hughes_1797	location	county_tyrone
jernej_kopitar	gender	male
maria_anna_of_bavaria	parents	henriette_adelaide_of_savoy
francisco_linares_alcantara	gender	male
givi_chokheli	location	telavi
george_sebastian_silzer	place_of_death	newark
yehuda_amichai	nationality	germany
john_andrew_la_nauze	institution	university_of_western_australia
john_a_gronouski	location	green_bay
james_paul_clarke	gender	male
ustad_abdul_wahid_khan	profession	singer
lionel_bart	place_of_death	hammersmith
emerson_dickman	gender	male
alessandro_rolla	profession	violist
richard_may	gender	male
mason_adams	gender	male
maggie_jones	gender	female
eleanor_of_aquitaine	children	henry_the_young_king
theodosius_harnack	children	adolf_von_harnack
antonio_salieri	gender	male
raoul_bott	religion	judaism
aud_egede_nissen	gender	female
thomas_patrick_gerrity	location	montana
g_k_chesterton	place_of_birth	kensington
abraham_lincoln	parents	thomas_lincoln
adam_blackwood	gender	male
jan_kociniak	place_of_death	warsaw
chaim_kreiswirth	religion	judaism
antonio_santelia	profession	architect
paripatra	parents	sunandha
heinrich_zschokke	place_of_death	aarau
juri_uluots	gender	male
gabriele_dannunzio	profession	librettist
belinda_lee	place_of_death	san_bernardino
lech_kaczynski	gender	male
earl_hines	ethnicity	african_american
hyman_minsky	profession	economist
chris_phatswe	cause_of_death	aids
giuseppe_farina	place_of_death	chambery
bill_grundy	location	manchester_united_kingdom
alfred_mond_1st_baron_melchett	gender	male
matthias_holy_roman_emperor	location	vienna
justin_winsor	location	boston_massachusetts
katharine_graham	institution	vassar_college
elie_cartan	institution	ecole_normale_superieure
almodis_de_la_marche	children	raymond_iv_of_toulouse
teodor_narbutt	nationality	poland
sam_walton	cause_of_death	bone_cancer
herman_vanderpoorten	gender	male
sergey_muromtsev	gender	male
elisabeth_of_tirol	place_of_birth	munich
ramon_sampedro	cause_of_death	poison
frederic_leighton_1st_baron_leighton	profession	painter
xia_gui	nationality	china
beatrice_chase	gender	female
john_van_buren	gender	male
danny_rapp	profession	singer
leonie_rysanek	place_of_death	vienna
bernhard_siegfried_albinus	nationality	germany
karoly_huszar	nationality	hungary
don_arden	profession	businessperson
syed_hussein_alatas	cause_of_death	myocardial_infarction
valentin_glushko	location	odessa
william_grant_still	profession	conducting
tomas_masaryk	gender	male
sonja_bernadotte	gender	female
gerhard_gentzen	location	greifswald
fitz_john_porter	gender	male
princess_victoria_of_hesse_and_by_rhine	nationality	germany
saboktakin_saloor	gender	male
jules_dassin	place_of_death	athens
robert_matthew	gender	male
jack_w_kelso	gender	male
william_h_hinton	children	joan_hinton
ivan_shishman_of_bulgaria	parents	ivan_alexander_of_bulgaria
thomas_duncombe_dee	cause_of_death	pneumonia
john_d_bulkeley	place_of_death	silver_spring
thomas_hodgkin	gender	male
howard_w_koch	profession	businessperson
boots_mallory	spouse	herbert_marshall
ruhollah_khomeini	ethnicity	persian_speakers_of_iran
carlo_francesco_nuvolone	location	milan_italy
gabrielle_rejane	place_of_birth	paris
guy_of_anderlecht	nationality	belgium
maria_of_montferrat	parents	isabella_of_jerusalem
vijay_hazare	gender	male
anthony_newley	gender	male
sir_william_spring_1st_baronet	gender	male
johnnie_cochran	cause_of_death	brain_tumor
kenneth_thomson_2nd_baron_thomson_of_fleet	cause_of_death	myocardial_infarction
william_kissam_vanderbilt_ii	profession	racecar_driver
sir_henry_thompson_1st_baronet	profession	novelist
pieter_post	place_of_birth	haarlem
ormsby_m_mitchel	gender	male
elizabeth_i_of_england	place_of_death	richmond_palace
margaret_mead	place_of_birth	philadelphia
abdul_razak	gender	male
wilson_pickett	cause_of_death	myocardial_infarction
john_kendrick_bangs	place_of_death	atlantic_city_new_jersey
john_philip_holland	profession	architect
richard_h_bayard	place_of_birth	wilmington
jose_emilio_gonzalez	institution	boston_university
jerry_wald	profession	businessperson
marriner_stoddard_eccles	place_of_birth	logan
scatman_john	gender	male
robert_byrd	place_of_death	washington_united_states
richard_i_of_normandy	parents	william_i_of_normandy
w_t_tutte	nationality	united_kingdom
george_taylor	place_of_birth	northern_ireland
louis-philippe_pelletier	gender	male
gunboat_smith	place_of_birth	philadelphia
clifford_milburn_holland	institution	harvard_university
manasseh_cutler	gender	male
gopal_krishna_gokhale	place_of_death	mumbai
erich_pommer	nationality	germany
orlow_w_chapman	gender	male
leon_trotsky	religion	atheism
mason_w_gross	institution	harvard_university
paavo_yrjola	nationality	finland
hugo_vivian_hope_throssell	gender	male
mitch_miller	profession	oboist
mike_mctigue	place_of_birth	county_clare
kazim_orbay	nationality	turkey
charles_diggs	ethnicity	african_american
stanislas_lepine	place_of_death	paris
james_goldsmith	location	paris
barbara_of_hesse	gender	female
p_g_wodehouse	nationality	united_kingdom
edgar_g_ulmer	nationality	germany
martin_luther_king_jr	gender	male
blanche_of_navarre	children	john_ii_duke_of_brittany
leone_battista_alberti	profession	author
herbert_horne	profession	architect
curtis_bernhardt	profession	film_director
manuel_ii_palaiologos	parents	john_v_palaiologos
daniel_defoe	nationality	england
hezekiah	gender	male
lynn_fontanne	gender	female
buck_baker	location	south_carolina
pope_benedict_iv	profession	pope
thomas_j_henderson_1931	profession	businessperson
gustaf_retzius	nationality	sweden
francis_i_of_france	spouse	eleanor_of_spain
roxana	spouse	alexander_the_great
elisabeth_of_bavaria	children	crown_prince_rudolf_of_austria
rachel_saint	parents	lawrence_saint
louis_de_jaucourt	gender	male
kurt_o_friedrichs	place_of_death	new_rochelle
eto_jun	location	tokyo
allison_hayes	cause_of_death	leukemia
henri-georges_clouzot	profession	film_director
ruggero_oddi	nationality	italy
guntram	parents	ingund_wife_of_clotaire_i
thomas_huxley	nationality	united_kingdom
arthur_von_posadowsky_wehner	nationality	germany
lee_wiley	gender	female
max_abramovitz	gender	male
roger_martin_du_gard	gender	male
james_byrne_1908	place_of_birth	saint_paul
irving_rapper	profession	film_director
harry_hammond_hess	cause_of_death	myocardial_infarction
wolfgang_amadeus_mozart	children	franz_xaver_wolfgang_mozart
frederic_tudor	location	boston_massachusetts
joseph_bonaparte	gender	male
cao_chong	place_of_birth	china
johannes_winkler	nationality	germany
martha_gellhorn	institution	bryn_mawr_college
benjamin_von_kallay	nationality	hungary
mark_lambert_bristol	institution	united_states_naval_academy
zden_k_mat_jka	gender	male
edward_conze	nationality	united_kingdom
hannibal_barca	place_of_birth	carthage
antonio_segni	religion	roman_catholic_church
donald_watson	place_of_death	keswick
peter_t_washburn	place_of_birth	lynn
fritz_lang	spouse	thea_von_harbou
leslie_groves	location	darien
prince_sigvard_duke_of_uppland	parents	princess_margaret_of_connaught
john_augustus_prince_of_anhalt_zerbst	place_of_birth	zerbst
james_britten	religion	roman_catholic_church
cheb_hasni	gender	male
karl_nobiling	gender	male
ritchie_valens	gender	male
jean-baptiste_breval	place_of_birth	paris
william_rolleston	place_of_birth	yorkshire
joseph_stalin	location	baku
barbara_woodhouse	nationality	united_kingdom
elizabeth_inchbald	place_of_death	kensington
andrea_orcagna	gender	male
erastus_snow	place_of_death	salt_lake_city
fritz_lang	profession	film_producer
jean_moreas	place_of_death	paris
washington_ellsworth_lindsey	profession	attorney_at_law
christian_ernst_stahl	gender	male
joseph_shehyn	gender	male
jose_emilio_gonzalez	profession	editor
candy_jones	place_of_birth	wilkes_barre
bernard_maybeck	location	berkeley_california
sadie_tanner_mossell_alexander	location	philadelphia
charles_diggs	gender	male
eilhard_mitscherlich	place_of_death	schoneberg
nissim_de_camondo	place_of_birth	paris
vince_taylor	cause_of_death	cancer
charles_paget_6th_marquess_of_anglesey	children	lady_rose_mclaren
shiv_dayal_singh	place_of_death	agra
francis_w_palmer	location	indiana
joseph_alioto	institution	the_catholic_university_of_america
edward_smith_stanley_14th_earl_of_derby	location	knowsley
gary_powers	place_of_death	encino
donald_russell_long	gender	male
gypsy_rose_lee	gender	female
al_barlick	profession	umpire
edward_terry_sanford	institution	harvard_law_school
racey_helps	location	bristol
robert_anton_wilson	institution	new_york_university
philipp_foltz	place_of_death	munich
wang_dulu	nationality	china
stefan_uro_iii_de_anski_of_serbia	parents	stefan_uro_ii_milutin_of_serbia
tilly_losch	spouse	edward_james
robert_m_la_follette_sr	children	robert_m_la_follette_jr
vilayat_inayat_khan	place_of_death	suresnes
edmund_ludlow	religion	baptist
ernst_von_dobschutz	gender	male
leopoldo_nobili	place_of_death	florence
francesco_antonio_bonporti	location	trento
caroline_blackwood	cause_of_death	cancer
harry_crookshank_1st_viscount_crookshank	nationality	united_kingdom
theodosius_i	place_of_death	milan_italy
ernest_elector_of_saxony	children	frederick_iii_elector_of_saxony
sancha_of_castile	parents	richeza_of_poland
max_planck	place_of_death	gottingen
kasturbhai_lalbhai	nationality	india
jack_doyle	profession	singer
frank_harte	location	county_dublin
jacques_derrida	location	algiers
ivan_merz	gender	male
emil_theodor_kocher	place_of_birth	berne
william_the_silent	cause_of_death	murder
sir_anthony_browne	spouse	elizabeth_clinton_countess_of_lincoln
archduke_maximilian_franz_of_austria	parents	maria_theresa_of_austria
ralph_waldo_emerson	place_of_birth	boston_massachusetts
maria_antonietta_of_spain	spouse	victor_amadeus_iii_of_sardinia
uriel_jones	place_of_death	dearborn
walker_percy	religion	catholic
ibrahim_egal	religion	sunni_islam
juan_de_arellano	place_of_death	madrid
andreas_cruesen	gender	male
domitian	gender	male
perry_watkins	cause_of_death	aids
princess_pauline_duchess_of_sagan	place_of_death	vienna
abraham_cowley	place_of_death	chertsey
joanne_simpson	institution	university_of_chicago
bill_bixby	institution	lowell_high_school
mihail_farcasanu	place_of_death	washington_united_states
miguel_de_cervantes	place_of_death	madrid
david_henry_souter	nationality	australia
janis_cakste	ethnicity	latvians
dorothy_parker	place_of_birth	long_branch
seth_kinman	profession	hunting
john_w_rollins	gender	male
rex_harrison	spouse	kay_kendall
jean-baptiste_lully	location	florence
desmond_llewelyn	nationality	wales
giovanni_amendola	location	salerno
louis_xv_of_france	spouse	maria_leszczynska
terence_rattigan	nationality	england
victor_raul_haya_de_la_torre	place_of_birth	trujillo
soong_may-ling	parents	charlie_soong
omer_seyfettin	profession	novelist
adele_sandrock	location	rotterdam
edward_woodward	institution	royal_academy_of_dramatic_art
jean-philippe_rameau	profession	composer
j_c_tremblay	profession	ice_hockey_player
georg_philipp_telemann	gender	male
murray_rothbard	profession	journalist
john_ballance	gender	male
mariana_of_austria	place_of_birth	vienna
ann_richards	religion	united_methodist_church
guibert_of_nogent	gender	male
eva_morris	location	stone
george_joseph_smith	cause_of_death	capital_punishment
graham_moffatt	location	hammersmith
rangjung_rigpe_dorje	gender	male
cosimo_de_medici	place_of_death	florence
david_douglas	profession	botanist
binger_hermann	place_of_death	roseburg
ettie_annie_rout	profession	persona_non_grata
dudley_moore	profession	film_producer
princess_elizabeth_of_sweden	parents	gustav_i_of_sweden
arnold_aletrino	gender	male
maximilian_ii_of_bavaria	parents	ludwig_i_of_bavaria
numa_droz	place_of_birth	la_chaux-de-fonds
riccardo_zanella	nationality	hungary
ernst_josephson	location	stockholm
princess_anna_amalia_of_prussia	parents	sophia_dorothea_of_hanover
leigh_harline	profession	composer
byron_white	institution	hertford_college_oxford
christodoulos	gender	male
abraham_louis_breguet	gender	male
edward_sinclair	nationality	united_kingdom
the_notorious_big	profession	rapping
margaret_theresa_of_spain	parents	mariana_of_austria
magnus_von_braun	profession	scientist
caspar_bartholin_the_elder	children	thomas_bartholin
titus	cause_of_death	fever
mary_dimmick_harrison	cause_of_death	asthma
alberto_lleras_camargo	profession	diplomat
tanaka_giichi	nationality	japan
valentin_alsina	children	adolfo_alsina
lonnie_frisbee	place_of_birth	costa_mesa
ivor_herbert_1st_baron_treowen	nationality	united_kingdom
edwige_feuillere	gender	female
william_feller	place_of_birth	zagreb
teresa_graves	gender	female
johann_michael_feuchtmayer	gender	male
ernst_kaltenbrunner	gender	male
moshe_teitelbaum	religion	orthodox_judaism
hans_sloane	profession	scientist
friedrich_wilhelm_ritschl	gender	male
tommaso_palamidessi	nationality	italy
ignaz_wechselmann	religion	judaism
anna_petrovna_of_russia	parents	peter_i_of_russia
elsa_lanchester	nationality	england
shiro_ishii	cause_of_death	cancer
dmitry_karakozov	place_of_birth	kostroma
benita_hume	spouse	george_sanders
victoria_princess_royal	children	prince_sigismund_of_prussia
john_w_reynolds	place_of_birth	green_bay
ma_sicong	profession	composer
eduard_bernstein	nationality	germany
simon_forman	nationality	united_kingdom
charles_marshall	gender	male
john_anthony_copeland_jr	location	ohio
archibald_campbell_1st_marquess_of_argyll	gender	male
francois_henri_de_franquetot_de_coigny	gender	male
ashi	gender	male
ray_davis	place_of_death	new_brunswick_new_jersey
william_bradford_1663	profession	printer
james_whitfield	place_of_birth	liverpool
william_i_of_normandy	children	richard_i_of_normandy
john_banner	gender	male
paul_johann_ludwig_von_heyse	nationality	germany
jessie_taft	institution	drake_university
ignatius_cardinal_kung_pin-mei	place_of_birth	shanghai
darryl_f_zanuck	profession	film_producer
robert_stewart_viscount_castlereagh	institution	st_johns_college_cambridge
dan_andersson	nationality	sweden
james_b_ray	place_of_birth	jefferson_county_kentucky
hugo_haas	cause_of_death	asthma
lavinia_fontana	location	bologna
menachem_begin	ethnicity	ashkenazi_jews
paul_newman	profession	film_director
dave_garroway	place_of_birth	schenectady
george_matheson	gender	male
srinivasa_ramanujan	location	tamil_nadu
adam_von_trott_zu_solz	profession	diplomat
ileen_getz	gender	female
ephraim_willard_burr	gender	male
harry_marshall_erskine_evans	institution	university_of_toronto
prince_joseph_clemens_of_bavaria	parents	princess_louise_victoire_dorleans_alencon
frederick_iv_elector_palatine	spouse	louise_juliana_of_nassau
dutta_samant	cause_of_death	assassination
wilhelm_zaisser	location	gelsenkirchen
ernst_friedrich_gurlt	gender	male
dick_francis	nationality	united_kingdom
william_thomas_stead	gender	male
joan_miro	place_of_birth	barcelona
nils_von_dardel	gender	male
yisrael_poliakov	location	jerusalem
langston_hughes	profession	dramatist
chris_schenkel	gender	male
m_clifford_townsend	religion	methodism
frances_perkins	place_of_death	new_york_state
gabor_body	gender	male
visakham_thirunal	gender	male
albert_of_saxe-coburg_and_gotha	spouse	victoria_of_the_united_kingdom
maxentius	parents	maximian
hercules_l_dousman	gender	male
valery_larbaud	place_of_birth	vichy
kiyoshi_shiga	nationality	japan
mariano_jose_de_larra	place_of_birth	madrid
petro_konashevych	gender	male
renee_of_france	place_of_death	montargis
cajetan_freiherr_von_felder	gender	male
vladimir_damgov	place_of_birth	sofia
makhan_lal_chaturvedi	profession	journalist
w_haydon_burns	religion	methodism
isadora_duncan	place_of_birth	san_francisco
louise_weiss	place_of_birth	arras
james_waldegrave_2nd_earl_waldegrave	spouse	maria_duchess_of_gloucester_and_edinburgh
sally_hayfron	gender	female
david_s_walker	gender	male
alexander_ii_of_russia	children	grand_duchess_alexandra_alexandrovna_of_russia
francesco_bartolozzi	place_of_birth	florence
william_wilkins	institution	dickinson_college
jan_baptist_weenix	gender	male
alfred_the_great	spouse	ealhswith
turner_cassity	profession	poet
walter_hunt	profession	inventor
antenor_orrego	nationality	peru
william_styron	cause_of_death	pneumonia
giovanni_antonio_scopoli	gender	male
shirley_stoler	gender	female
ben_bagley	profession	record_producer
aleksandr_pushkin	place_of_death	saint_petersburg
charlie_parker	gender	male
lynn_redgrave	cause_of_death	breast_cancer
paul_painleve	location	paris
florent_schmitt	profession	composer
alexandre_angelique_de_talleyrand_perigord	place_of_death	paris
hannes_skold	gender	male
robert_kekewich	institution	marlborough_college
saint_homobonus	gender	male
adrianus_valerius	place_of_birth	middelburg
robert_rowand_anderson	ethnicity	scottish_people
shushanik_kurghinian_1876	place_of_death	yerevan
colin_mccahon	gender	male
adolphus_busch	parents	eberhard_anheuser
richard_biggs	place_of_birth	columbus_ohio
henry_more	gender	male
matt_gadsby	place_of_death	harrogate
hercules_l_dousman	profession	businessperson
joseph_carter_abbott	location	wilmington_north_carolina
eugenio_maria_de_hostos	gender	male
akiva_eger	children	samuel_benjamin_sofer
leonid_azkaldian	nationality	armenia
francisco_pradilla_ortiz	nationality	spain
tom_lantos	nationality	hungary
piero_valeriano_bolzani	nationality	italy
blanche_sweet	spouse	marshall_neilan
lotte_h_eisner	place_of_death	paris
isabella_of_valois	place_of_birth	paris
linus_pauling	gender	male
karl_joseph_alter	location	toledo_ohio
screaming_lord_sutch	cause_of_death	suicide
james_thurber	gender	male
colleen_kay_hutchins	institution	brigham_young_university
john_atkinson_grimshaw	profession	painter
hermann_abert	place_of_birth	stuttgart
anna_laetitia_barbauld	nationality	united_kingdom
walter_capps	institution	yale_university
jonas_lie	place_of_birth	modum
sir_charles_hawtrey	gender	male
eulalio_gutierrez	place_of_death	saltillo
mary_ure	institution	central_school_of_speech_and_drama
omond_solandt	profession	scientist
david_g_burnet	location	texas
william_g_zuern_jr	cause_of_death	capital_punishment
robin_tyner	gender	male
michael_gilden	cause_of_death	suicide
marguerite_durand	profession	journalist
andrew_ehrenberg	gender	male
julian_the_apostate	children	procopius_0326
peter_i_of_russia	parents	alexis_i_of_russia
john_napier	gender	male
u_n_gunasekera	institution	university_of_london
joe_kennaway	nationality	scotland
prasanta_chandra_mahalanobis	institution	presidency_college_kolkata
julien_green	institution	university_of_virginia
james_b_ray	gender	male
suzanne_despres	spouse	aurelien_lugne-poe
rudolf_ii_holy_roman_emperor	parents	maria_of_spain
kai_ho	institution	university_of_aberdeen
colin_macleod	gender	male
lord_randolph_churchill	spouse	jennie_churchill
moritz_michael_daffinger	gender	male
patrick_gleason	gender	male
irene_joliot-curie	spouse	frederic_joliot-curie
ruy_gonzales_de_clavijo	gender	male
florence_peshine_eagleton	location	newark
george_bernard_shaw	gender	male
ephraim_katzir	nationality	israel
charles_lindbergh	parents	charles_august_lindbergh
oscar_gustave_rejlander	nationality	united_kingdom
case_broderick	gender	male
svante_arrhenius	place_of_death	stockholm
princess_charlotte_of_prussia	parents	frederick_iii_german_emperor
jo_ann_davis	location	north_carolina
benedict_friedlander	nationality	germany
mikhail_saltykov-shchedrin	profession	journalist
warwick_deeping	place_of_death	weybridge
stanley_black	gender	male
george_edward_grey	place_of_birth	lisbon
lotte_h_eisner	nationality	germany
carl_eduard_duke_of_saxe_coburg_and_gotha	gender	male
theodor_fischer	gender	male
francisco_manuel_trigoso	gender	male
giovanni_battista_guadagnini	gender	male
mickey_cochrane	place_of_death	lake_forest
pimp_c	place_of_death	west_hollywood
larry_h_smith	gender	male
tomas_macgiolla	location	county_tipperary
john_matshikiza	ethnicity	xhosa
fahri_koruturk	nationality	turkey
leroy_anderson	gender	male
