yvonne_fletcher	james_donald
yumeno_kyusaku	koki_hirota
yasser_arafat	naguib_mahfouz
william_e_purcell	danny_federici
vernon_dahmer	luther_perkins
vasili_i_of_russia	ivan_ii_of_russia
tsanko_dyustabanov	abidin_dino
thursday_october_christian_ii	fletcher_christian
thomas_ammann	heinz_berggruen
tetsuji_takechi	motojiro_kajii
stanley_milgram	mathew_brady
simeon_wheelock	paul_c_whitin
sher_ali_khan	hafizullah_amin
sergio_osmena	manuel_l_quezon
rowland_hussey_macy	george_fawcett
pierre_louis_charles_de_failly	francois_dyrek
pierre_francois_leonard_fontaine	nicholas_flamel
olof_swartz	moa_martinson
nagai_naoyuki	honda_tadakatsu
moran_family	judy_moran
mily_balakirev	anatoly_marienhof
mikalojus_radvila_the_old	anna_of_masovia
me_phi_me	duane_d_hackney
mathias_wieman	justus_moser
masaru_ibuka	akashi_shiganosuke
marguerite_batarde_de_france	burgundy
ivan_goremykin	alexander_fersman
heinrich_duke_of_saxe_romhild	albrecht_duke_of_saxe_coburg
hans_von_seeckt	asmus_jacob_carstens
hans_buchner	august_natterer
germany_schulz	george_w_wood
florence_r_sabin	alfred_blalock
ferdinand_vandeveer_hayden	anne_pitoniak
earl_dutch_clark	bird_millman
charles_iii_duke_of_parma	carlos_duke_of_madrid
bill_wendell	albert_w_johnson
amir_abdollah_tahmasebi	abdolhossein_zarinkoob
alexander_luders	a_d_gordon
tony_wilding	reginald_doherty
probus	maximian
shilendra_kumar_singh	shah_jahan
maria_fyodorovna_of_russia	augusta_of_saxe-weimar
napoleon_victor_jerome_frederic_bonaparte	marie_henriette_of_austria
richard_bennett	barbara_bennett
joan_bennett	barbara_bennett
princess_clementine_of_belgium	napoleon_joseph_charles_paul_bonaparte
nobuyuki_abe	daisetz_teitaro_suzuki
nicolas_bachelier	john_iv_duke_of_brabant
nicolas_bachelier	francis_de_gaston_chevalier_de_levis
milica_stojadinovic-srpkinja	josif_runjanin
juan_villafuerte	juan_montalvo
juan_villafuerte	galo_plaza
jovan_jovanovic_zmaj	josif_runjanin
henry_bellmon	don_haskins
glenda_farrell	don_haskins
milica_stojadinovic-srpkinja	jovan_jovanovic_zmaj
juan_montalvo	galo_plaza
john_iv_duke_of_brabant	francis_de_gaston_chevalier_de_levis
henry_bellmon	glenda_farrell
maria_pavlovna_of_russia	friedrich_ii_eugen_duke_of_wurttemberg
jahangir	agra
aurangzeb	agra
sorghaghtani_beki	male
waldorf_astor_2nd_viscount_astor	male
princess_marie_bonaparte	male
zulfikar_ali_bhutto	male
ursula_thiess	male
margaret_of_parma	male
vibia_sabina	male
poppaea_sabina	male
william_penn_1621	male
rachel	male
william_pitt_1st_earl_of_chatham	male
infante_carlos_count_of_molina	gosport
jehan_bellegambe	constant_dutilleux
pippin_of_landen	ghent
louis_xviii_of_france	female
kenneth_harlan	female
john_holland_1st_duke_of_exeter	female
lindsay_crosby	female
mr_a_helfferich	female
william_bridges_adams	female
stefan_uro_ii_milutin_of_serbia	female
john_c_calhoun	female
prince_louis_ferdinand_ii_of_prussia	female
william_de_braose_lord_of_abergavenny	female
yixin_prince_gong	female
selim_ii	female
pippin_of_italy	female
philip_v_of_france	female
gordon_m_craig	bill_mcgunnigle
walter_huston	emphysema
jahangir	aurangzeb
princess_clementine_of_belgium	prince_leopold_duke_of_brabant
princess_clementine_of_belgium	duchess_maria_dorothea_of_wurttemberg
henry_vii_holy_roman_emperor	claude_le_jeune
victoria_kinoiki_kekaulike	male
prince_leopold_duke_of_brabant	duchess_maria_dorothea_of_wurttemberg
reginald_doherty	christchurch
probus	fausta
willie_simms	male
lee_falk	bart_macomber
napoleon_joseph_charles_paul_bonaparte	marie_henriette_of_austria
elihu_b_washburne	cadwallader_c_washburn
infanta_maria_francisca_countess_of_molina	charles_iv_of_spain
mickey_cochrane	harry_s_truman
frederick_w_seward	female
leslie_lynch_king_sr	female
gerald_rudolff_ford	female
princess_ludovika_of_bavaria	maximilian_joseph_duke_in_bavaria
patricia_goldman_rakic	johnnie_cochran
william_eden_1st_baron_auckland	male
tsarevich_ivan_ivanovich_of_russia	tsarevich_dimitri
manuel_curros_enriquez	concepcion_arenal
kurt_winter	john_norquay
kay_kyser	frank_porter_graham
karl_wilhelm_von_kupffer	heinrich_lenz
jozef_szajna	hieronim_augustyn_lubomirski
john_philip_sousa	gus_yatron
jose_p_laurel	james_h_polk
william_iv_duke_of_bavaria	female
pyotr_alexandrovich_chikhachov	kondraty_fyodorovich_ryleyev
johan_ferrier	fred_patrick
peter_lalor	james_fintan_lalor
manuel_castro_ruiz	josefa_ortiz_de_dominguez
princess_sophie_of_greece_and_denmark	male
ruth_cheney_streeter	male
louis_prima	al_bowlly
therese_malten	michael_andreas_barclay_de_tolly
olav_duun	agathe_backer_grondahl
lady_jane_grey	arbella_stuart
john_mccourt	fern_hobbs
david_herold	caleb_bradham
zenas_bliss	ephraim_willard_burr
zelimkhan_yandarbiyev	samir_kassir
yeiki_kobashigawa	sokon_matsumura
william_spratling	william_p_harrison
william_henry_phelps	peter_camejo
william_henry_bramble	nelson_h_barbour
william_gropper	raul_julia
william_clito	matthew_of_alsace
william_c_mooney	edwin_conklin
vladimir_alekseyevich_betz	mykhailo_hrushevsky
thomas_j_mcintyre	claude_rains
thomas_hare	harold_lasswell
tamon_yamaguchi	friedensreich_hundertwasser
tamanoumi_masahiro	takeda_ayasaburo
s_subramania_iyer	muthuswami_dikshitar
russell_lloyd	peter_tanner
rudolf_von_bennigsen	niklas_luhmann
roy_buchanan	dallas_lynn_peck
robert_william_bilton_hornby	piers_merchant
richard_mead	lionel_bart
rene_waldeck-rousseau	jean_louis_tulou
prince_eugen_duke_of_narke	gustaf_v_of_sweden
pippin_the_younger	nicolas_catinat
pedro_joaquin_chamorro	diego_vigil_cocana
paul_johann_anselm_ritter_von_feuerbach	johann_georg_von_hahn
paul_granlund	luther_youngdahl
noel_redding	arthur_brough
nik_radev	eddie_leonski
mohamed_hamri	ibn_battuta
michael_c_kerr	elisha_f_paxton
maurice_barrymore	bholu_pahalwan
jules_tannery	antoine_forqueray
juho_kusti_paasikivi	jean_sibelius
juan_bautista_vicini_burgos	eulalio_gutierrez
joseph_johann_littrow	friedrich_hopfner
john_h_clifford	albert_pinkham_ryder
john_fairfield	emery_j_san_souci
john_couch_adams	humphry_davy
john_barry_1873	james_oneill
john_akii-bua	daudi_cwa_ii_of_buganda
janos_csonka	istvan_bibo
jack_kerouac	gustavus_fox
hollis_frampton	arthur_compton
henry_bruce_1st_baron_aberdare	desmond_llewelyn
george_marshall	george_e_seney
cuno_amiet	bernhard_hammer
charles_longuet	argenteuil
carl_westman	boris_hagelin
cardinal_rodolfo_pio_da_carpi	bernardino_cardinal_spada
young_man_afraid_of_his_horses	male
william_holland_thomas	male
sibylla_of_anjou	male
mervyn_stockwood	male
kim_edward_beazley	eric_john_underwood
stevens_thomson_mason	male
norman_robertson	male
louis_x_duke_of_bavaria	albert_iii_duke_of_bavaria
neil_hamilton_1899	clarence_emir_allen
john_w_daniel	daniel_weisiger_adams
bianca_maria_sforza	anne_of_brittany
tadeusz_tanski	regina_jonas
richard_w_guenther	david_herold
richard_w_guenther	caleb_bradham
lee_falk	jerry_orbach
jerry_orbach	bart_macomber
michael_ramsey	george_cecil_ives
mary_of_york	edward_vi_of_england
walter_winchell	male
william_wetmore_story	male
robert_p_patterson	male
willard_saulsbury_sr	jeff_komlo
mo_teh_hui	guyuk_khan
philippa_of_lancaster	infanta_isabel_of_portugal
richard_r_taylor	male
ralph_buchsbaum	male
maria_anna_of_spain	margarita_of_austria
samuel_tertius_galton	birmingham
nathan_smith_1770	kay_sage
taufaahau_tupou_iv	female
publius_septimius_geta	female
ronald_a_parise	earl_derr_biggers
murad_iv	doug_harvey
murad_iv	bella_guerin
doug_harvey	bella_guerin
margaret_curtis	male
william_clito	male
s_subramania_iyer	male
russell_lloyd	male
noel_redding	male
maurice_barrymore	male
michael_billington	male
sol_lewitt	male
zenas_bliss	male
william_gropper	male
nicolas_catinat	male
niklas_luhmann	male
william_p_harrison	male
nik_radev	male
mohamed_hamri	male
zelimkhan_yandarbiyev	male
wolfgang_wagner	male
maria_anna_thekla_mozart	male
william_henry_bramble	male
pedro_joaquin_chamorro	male
thomas_j_mcintyre	male
robert_william_bilton_hornby	male
william_c_mooney	male
rene_waldeck-rousseau	male
mykhailo_hrushevsky	male
sokon_matsumura	male
peter_camejo	male
prince_eugen_duke_of_narke	male
tamon_yamaguchi	male
richard_mead	male
takeda_ayasaburo	male
william_of_volpiano	richard_ii_duke_of_normandy
susanna_of_bavaria	female
ted_stevens	patricia_goldman_rakic
ted_stevens	johnnie_cochran
wanda_wasilewska	male
stanislaw_samostrzelnik	male
prince_karl_of_hesse_and_by_rhine	male
sequoyah	joseph_wood_krutch
joseph_wood_krutch	archie_campbell
sequoyah	archie_campbell
robert_steinhauser	gerhard_schopfel
robert_steinhauser	anton_dominik_fernkorn
gerhard_schopfel	anton_dominik_fernkorn
zelda_fitzgerald	robert_y_hayne
zelda_fitzgerald	kenneth_noland
william_boyce_thompson	little_wolf
william_boyce_thompson	james_porter
william_a_wellman	owen_brewster
sunthorn_phu	pannarai
sunthorn_phu	damrong_rajanubhab
robert_y_hayne	kenneth_noland
proof_1975	j_dilla
proof_1975	big_l
pannarai	damrong_rajanubhab
owen_brewster	oscar_zariski
max_yasgur	dave_fultz
max_yasgur	anthony_jerome_griffin
little_wolf	james_porter
j_dilla	big_l
dave_fultz	anthony_jerome_griffin
william_a_wellman	oscar_zariski
kunigunde_of_austria	albert_iii_duke_of_bavaria
louis_x_duke_of_bavaria	kunigunde_of_austria
sava_tekelija	frederick_knefler
grand_duchess_olga_nikolaevna_of_russia	female
jack_webb	female
petar_beron	georgi_sava_rakovski
rodolfo_amando_philippi	male
marta_colvin	male
shilendra_kumar_singh	jahangir
shilendra_kumar_singh	aurangzeb
friedrich_ii_eugen_duke_of_wurttemberg	augusta_of_saxe-weimar
robert_barclay_fox	male
philip_iii_of_spain	female
william_of_volpiano	richard_i_of_normandy
prince_leopold_duke_of_brabant	napoleon_victor_jerome_frederic_bonaparte
napoleon_victor_jerome_frederic_bonaparte	duchess_maria_dorothea_of_wurttemberg
richard_kuhn	male
paul_stackel	male
simon_bolivar_buckner_jr	hart_county_kentucky
laurence_s_baker	bud_holland
john_mckinley	isaac_r_trimble
peter_iii_of_portugal	female
infante_joao_of_portugal	female
june_thorburn	jonathan_hutchinson
simon_patrick	edward_de_vere_17th_earl_of_oxford
jorge_isaacs	gerhard_thyben
edward_feild	c_b_fry
leslie_lynch_king_sr	gerald_rudolff_ford
victoria_kinoiki_kekaulike	abigail_kapiolani_kawananakoa
josephine_de_beauharnais	carlo_buonaparte
garcia_iv_of_pamplona	ferdinand_i_of_leon
prince_berthold_margrave_of_baden	baden-baden
willem_mengelberg	male
wil_huygen	male
samuel_abraham_goudsmit	male
roel_de_mon	male
raymond_westerling	male
pieter_paulus	male
piet_mondrian	male
napoleon_louis_bonaparte	male
michiel_jansz_van_mierevelt	male
kim_edward_beazley	dorothy_hewett
eric_john_underwood	dorothy_hewett
perry_miller	male
herbert_henry_dow	broda_barnes
russell_mcwhortor_cunningham	male
john_crown_prince_of_portugal	female
simon_bolivar_buckner_sr	male
pierre_vladimiroff	male
yuri_lotman	male
yevgeny_vesnik	male
yegor_ivanovich_zolotarev	male
vyacheslav_von_plehve	male
pavel_pestel	male
nikolay_adlerberg	male
nikolai_tcherepnin	male
mikhail_speransky	male
michel_fokine	male
wilhelm_ostwald	karl_wilhelm_von_kupffer
wilhelm_ostwald	heinrich_lenz
vasyl_velychkovsky	kurt_winter
vasyl_velychkovsky	john_norquay
tsarevich_ivan_ivanovich_of_russia	feodor_i_of_russia
tsarevich_dimitri	feodor_i_of_russia
pablo_iglesias	manuel_curros_enriquez
pablo_iglesias	concepcion_arenal
kay_kyser	howard_t_odum
jozef_szajna	jerzy_grotowski
john_philip_sousa	gerry_mulligan
jerzy_grotowski	hieronim_augustyn_lubomirski
howard_t_odum	frank_porter_graham
gus_yatron	gerry_mulligan
victor_keppler	male
ueno_hikoma	male
roy_pinney	male
peter_berlin	male
otto_felix	male
oscar_gustave_rejlander	male
shunkichi_kikuchi	male
lady_jane_grey	female
olav_duun	female
michael_andreas_barclay_de_tolly	female
john_mccourt	female
vytautas_the_great	male
theodor_franz_count_baillet_von_latour	male
vicente_martinez_ybor	male
vincenzo_righini	male
richard_b_anderson	harry_kalas
harry_kalas	don_rich
harry_kalas	dinsmore_alter
sebastiano_del_piombo	male
pietro_bembo	male
zhang_heng	male
willard_van_orman_quine	male
wang_yangming	male
thomas_more	male
simone_de_beauvoir	male
sholom_dovber_schneersohn	male
roger_bacon	male
posidonius	male
peter_stephen_duponceau	male
nikolai_fyodorovich_fyodorov	male
oliver_james_dickey	male
murad_iv	bobo_newsom
doug_harvey	bobo_newsom
bobo_newsom	bella_guerin
utah_phillips	male
ted_kennedy_1925	male
milan_paumer	male
ted_bundy	robert_e_bush
studs_terkel	male
thomas_coryat	male
yuriko_miyamoto	william_henry_harrison
william_henry_harrison	fireball_roberts
william_henry_harrison	christopher_reeve
maria_ii_of_portugal	male
vladimir_gardin	male
leon_delacroix	georg_loeschcke
leon_delacroix	egon_eiermann
leon_delacroix	alexander_mikhailovich_gorchakov
georg_loeschcke	egon_eiermann
georg_loeschcke	alexander_mikhailovich_gorchakov
egon_eiermann	alexander_mikhailovich_gorchakov
wojciech_korfanty	male
william_kingdon_clifford	male
pier_gerlofs_donia	male
leopold_infeld	edward_kofler
vasubandhu	male
vasile_voiculescu	male
titu_maiorescu	male
thurgood_marshall	male
thomas_savig_kleppe	male
yuan_jiang	male
wen_tong	male
mi_fu	male
zhang_chongren	male
xu_gu	male
william_simpson	male
wen_jia	male
wang_zhenpeng	male
tove_jansson	male
sun_kehong	male
nadezda_petrovic	male
mei_qing	male
zhang_wo	male
umberto_bindi	male
thomas_couture	male
t_c_cannon	male
peter_paul_rubens	male
peder_severin_kroyer	male
maurice_prendergast	male
paul_dubreil	male
marcel_brillouin	male
william_shainline_middleton	male
robert_m_la_follette_sr	male
tiradentes	male
walter_houser_brattain	male
robert_noyce	male
nicolas-joseph_cugnot	male
wordsworth_donisthorpe	male
samuel_w_alderson	male
sam_b_williams	male
otis_boykin	male
mickey_cochrane	jack_daniel
juan_count_of_montizon	infanta_maria_francisca_countess_of_molina
sidney_james_webb_1st_baron_passfield	male
frederick_viii_of_denmark	amalienborg_palace
robert_roswell_palmer	male
samuel_gardner_drake	male
peter_englund	male
norman_cohn	male
patrick_hastings	male
yunmen_wenyan	male
soen_nakagawa	male
sirimavo_bandaranaike	male
nishida_kitaro	male
tatsuo_yoshida	bill_tytla
victor_steinbrueck	male
prince_maximilian_of_baden	male
lovisa_of_sweden	christian_ix_of_denmark
oliver_o_howard	male
tadeusz_chylinski	robert_r_gilruth
tadeusz_chylinski	patrick_young_alexander
tadeusz_chylinski	mikhail_pomortsev
robert_r_gilruth	patrick_young_alexander
robert_r_gilruth	mikhail_pomortsev
patrick_young_alexander	mikhail_pomortsev
pope_lucius_ii	male
pope_stephen_ix	male
pope_sisinnius	male
pope_silvester_ii	male
pope_sergius_iv	male
pope_pontian	male
pope_paul_v	male
pope_john_xviii	male
pope_honorius_iii	male
pope_gregory_xi	male
pope_gelasius_ii	male
pope_felix_iv	male
pope_clement_iv	male
pope_benedict_iv	male
ruth_handler	male
marie_of_hohenstaufen	leuven
vsevolod_pudovkin	male
vasily_shukshin	male
roland_topor	male
robert_ardrey	male
robert_anderson_1917	male
richard_murphy_1912	male
rupert_mayer	male
william_h_upham	male
winfield_scott_hancock	male
william_hood_simpson	male
ulysses_s_grant_iii	male
thomas_selfridge	male
thomas_d_milling	male
stephen_d_lee	male
richard_delafield	male
nathaniel_lyon	male
malin_craig	male
victor_herbert	male
