Eli_Wallach	almaMater	University_of_Texas_at_Austin
Groucho_Marx	genre	Slapstick
Halle_Berry	occupation	Film_producer
J._R._R._Tolkien	deathPlace	Bournemouth
James_Whale	birthPlace	England
Jack_Kemp	birthPlace	California
Kinky_Friedman	almaMater	University_of_Texas_at_Austin
Diana,_Princess_of_Wales	birthPlace	England
Ronald_Coase	almaMater	London_School_of_Economics
Soad_Hosny	deathPlace	London
Twin_Peaks	starring	Dana_Ashbrook
Tabitha_King	genre	Horror_fiction
Thomas_Paine	birthPlace	Kingdom_of_Great_Britain
Wendell_Willkie	birthPlace	Indiana
Christopher_Tolkien	birthPlace	England
Goldie	hometown	West_Midlands_(county)
Victor_McLaglen	birthPlace	Royal_Tunbridge_Wells
George_V	birthPlace	London
Isabella_of_France	deathPlace	Norfolk
Anthony_Burgess	deathPlace	England
Henry_Mancini	birthPlace	Cleveland
Charles_Beaumont	genre	Social_commentary
Quantum_Leap	producer	Deborah_Pratt
Jack_Vance	genre	Mystery_fiction
Jeffery_Amherst,_1st_Baron_Amherst	birthPlace	Kingdom_of_Great_Britain
Margaret_Atwood	almaMater	Victoria_University,_Toronto
James_Hilton_(novelist)	almaMater	Christ's_College,_Cambridge
Chuck_Palahniuk	almaMater	University_of_Oregon
J._J._Thomson	deathPlace	England
J._J._Thomson	almaMater	University_of_Manchester
David_Brin	occupation	NASA
Nevil_Shute	birthPlace	England
Kazuo_Ishiguro	occupation	Songwriter
Derek_Bailey_(guitarist)	birthPlace	Sheffield
Rosalind_Franklin	deathPlace	London
Robin_Milner	birthPlace	England
Isaac_Barrow	almaMater	University_of_Cambridge
Ravi_Shankar	birthPlace	British_Raj
Rod_Serling	birthPlace	Syracuse,_New_York
The_Lonely_(The_Twilight_Zone)	writer	Rod_Serling
John_Singer_Sargent	deathPlace	London
What_You_Need_(The_Twilight_Zone)	writer	C._L._Moore
Adam_Clayton	birthPlace	England
Alexander_Knox	deathPlace	England
Andrew_Huxley	birthPlace	England
A_Nice_Place_to_Visit	writer	Charles_Beaumont
George_Villiers,_1st_Duke_of_Buckingham	birthPlace	England
Raquel_Welch	birthPlace	Illinois
Deryck_Guyler	birthPlace	Cheshire
Fritz_Perls	deathPlace	Illinois
Dwayne_Johnson	birthPlace	Hayward,_California
The_Arrival_(The_Twilight_Zone)	writer	Rod_Serling
Bill_Owen_(actor)	deathPlace	England
Ewan_MacColl	deathPlace	London
Glenda_Jackson	birthPlace	England
Ginger_Baker	associatedMusicalArtist	Blind_Faith
Elias_Disney	deathPlace	California
Sliders	starring	Cleavant_Derricks_(actor)
Earth,_Wind_&_Fire	associatedBand	Charles_Stepney
Robert_Rankin	genre	Fiction
John_C._Baez	almaMater	Princeton_University
Paula_Yates	deathPlace	London
Sienna_Guillory	birthPlace	England
Stuart_Bell	birthPlace	County_Durham
Marie_Prevost	deathPlace	Hollywood
Jay_Ward	birthPlace	San_Francisco
Anne_Baxter	birthPlace	Indiana
John_Gilbert_(actor)	deathPlace	Bel_Air,_Los_Angeles
Renée_Zellweger	almaMater	University_of_Texas_at_Austin
Shari_Lewis	deathPlace	California
Ramsey_Clark	almaMater	University_of_Chicago
Derek_Nimmo	birthPlace	England
Kerry_King	recordLabel	Metal_Blade_Records
Richard_Dawson	deathPlace	California
Haruki_Murakami	genre	Literary_realism
Anton_LaVey	occupation	Priest
David_Whitaker_(screenwriter)	deathPlace	London
Harold_Ramis	deathPlace	Glencoe,_Illinois
Cass_Elliot	deathPlace	London
Stephen_Ward	deathPlace	England
Madeleine_Carroll	birthPlace	England
Princess_Alice_of_Battenberg	deathPlace	London
Lil_Green	deathPlace	Illinois
Bill_Janklow	almaMater	Juris_Doctor
Wilfred_Thesiger	deathPlace	Croydon
Wilfred_Thesiger	deathPlace	England
Elihu_Thomson	almaMater	Tufts_University
Zoot_Sims	birthPlace	California
Stan_Getz	associatedMusicalArtist	Gary_Burton
W._W._Rouse_Ball	deathPlace	England
Arthur_Cayley	almaMater	Trinity_College,_Cambridge
Ruth_Rendell	birthPlace	Essex
Walter_Tevis	birthPlace	California
Walter_Tevis	occupation	Short_story
Inger_Stevens	birthPlace	Stockholm
Mark_Romanek	birthPlace	Illinois
Charles_James_Napier	birthPlace	Palace_of_Whitehall
Charles_A._Beard	deathPlace	Connecticut
Michael_Foster_(physiologist)	deathPlace	England
Ben_Nighthorse_Campbell	birthPlace	California
James_Mansergh	deathPlace	London
Anthony_Newley	birthPlace	England
Richard_K._Morgan	genre	Science_fiction
Charles_Shaw-Lefevre,_1st_Viscount_Eversley	birthPlace	England
Harish-Chandra	deathPlace	Princeton,_New_Jersey
Walter_H._Breen	genre	Science_fiction
Robert_Rolfe,_1st_Baron_Cranworth	deathPlace	London
Dan_Burton	birthPlace	Indiana
Baron_Hill	birthPlace	Indiana
C._F._Powell	birthPlace	England
Frederick_Hervey,_4th_Earl_of_Bristol	birthPlace	Suffolk
Frederick_Hervey,_4th_Earl_of_Bristol	occupation	Clergy
Wyatt_Earp	birthPlace	Illinois
Jim_McDermott	almaMater	University_of_Illinois_at_Chicago_College_of_Medicine
Nancy_Johnson	birthPlace	Illinois
Alan_Howarth,_Baron_Howarth_of_Newport	almaMater	King's_College,_Cambridge
Tung-Yen_Lin	birthPlace	China
Pauline_Baynes	birthPlace	Sussex
John_Kessel	birthPlace	Buffalo,_New_York
Tony_Colman_(politician)	almaMater	University_of_East_Anglia
David_Drew_(politician)	almaMater	University_of_Nottingham
Haing_S._Ngor	deathPlace	California
Paul_Goodman_(politician)	birthPlace	London
Jake_2.0	starring	Keegan_Connor_Tracy
Kevin_Hughes_(politician)	deathPlace	England
John_Horam	birthPlace	City_of_Preston,_Lancashire
Julia_Morgan	birthPlace	San_Francisco
Bruce_Chatwin	birthPlace	England
Joan_D._Vinge	birthPlace	Baltimore
K._A._Applegate	birthPlace	Ann_Arbor,_Michigan
Louis_W._Tordella	birthPlace	Indiana
Owen_Willans_Richardson	almaMater	University_of_Cambridge
Tom_Hicks	almaMater	University_of_Texas_at_Austin
Dafydd_Wigley	birthPlace	Derby
St._Elsewhere	starring	Ed_Begley,_Jr.
Leslie_Orgel	almaMater	University_of_Chicago
Neil_Morrissey	birthPlace	England
William_Spottiswoode	birthPlace	England
Frank_Morley	deathPlace	Baltimore
James_Henry_Lane_(Union_general)	birthPlace	Lawrenceburg,_Indiana
Alvy_Moore	birthPlace	Vincennes,_Indiana
Sara_Cox	birthPlace	Greater_Manchester
Milton_Ager	hometown	Illinois
Isabel_Sanford	deathPlace	California
Ivan_Yefremov	genre	Science_fiction
Edgar_Adrian	birthPlace	London
Paul_Langevin	birthPlace	Paris
Paul_Langevin	almaMater	University_of_Cambridge
William_Bingham	deathPlace	Bath,_Somerset
Hugh_Fearnley-Whittingstall	birthPlace	London
Oliver_P._Morton	deathPlace	Indiana
The_51st_State	writer	Stel_Pavlou
Kate_Garraway	birthPlace	England
Taken_(miniseries)	starring	Julie_Benz
Timothy_Kirkhope	birthPlace	Newcastle_upon_Tyne
Soopafly	associatedBand	Roscoe_(rapper)
Charles_Frederick_Crisp	birthPlace	England
Edward_Fitzsimmons_Dunne	deathPlace	Illinois
John_Thomas_Dunlop	birthPlace	Placerville,_California
Harold_H._Velde	birthPlace	Illinois
Frank_Belknap_Long	deathPlace	New_York_City
Frank_Belknap_Long	genre	American_literature
Alfonso_López_Pumarejo	occupation	Economist
Richard_Laurence_Millington_Synge	birthPlace	England
Lenny_Breau	deathPlace	California
Thomas_Mitchell_(actor)	birthPlace	New_Jersey
Charles_Scott_Sherrington	birthPlace	Islington
The_4400	starring	Brooke_Nevin
Klaus_Roth	deathPlace	Inverness
Barbara_Hutton	birthPlace	New_York_City
L._Wolfe_Gilbert	deathPlace	California
Giovanni_Ribisi	birthPlace	California
David_Renwick	birthPlace	England
Margaret_Cole	birthPlace	England
Babylon_5:_The_Gathering	starring	Michael_O'Hare
Sophie_Monk	hometown	Gold_Coast,_Queensland
Hermann_Hauser	almaMater	University_of_Cambridge
Thomas_Kuchel	birthPlace	California
Pat_Phoenix	deathPlace	Stockport
Bryce_Dallas_Howard	birthPlace	California
Godfrey_Hounsfield	birthPlace	Nottinghamshire
Dead_Run_(The_Twilight_Zone)	writer	Greg_Bear
The_Twonky	starring	Hans_Conried
Robert_Brown_(British_actor)	deathPlace	Dorset
Richard_Cromwell_(actor)	birthPlace	California
Claude_R._Wickard	almaMater	Purdue_University
Geoffrey_Sax	birthPlace	England
Edward_Daniel_Clarke	deathPlace	United_Kingdom_of_Great_Britain_and_Ireland
Kathleen_Brown	birthPlace	California
Charles_N._Felton	deathPlace	California
Gabrielle_Anwar	birthPlace	Surrey
John_Peel_(writer)	birthPlace	Nottingham
Isaac_Featherston	deathPlace	England
Dave_Berry_(presenter)	birthPlace	England
Kevin_Bond_(footballer)	birthPlace	England
Madeline_Smith	birthPlace	England
Frederick_Weld	birthPlace	England
Ross_Alexander	deathPlace	California
Richard_Glazebrook	deathPlace	Surrey
Mark_Mancina	occupation	Composer
Roy_Owen_West	deathPlace	Illinois
John_Howard_(American_actor)	deathPlace	California
Ted_Dekker	genre	Mystery_fiction
William_Henry_Giles_Kingston	birthPlace	England
Billy_Fury	birthPlace	Liverpool
Richard_Carpenter_(screenwriter)	deathPlace	England
Chris_Helme	birthPlace	England
Joe_Fagan	deathPlace	England
Mako_Iwamatsu	deathPlace	California
Ken_Foree	birthPlace	Indianapolis
Jon_King	birthPlace	London
Jon_King	birthPlace	England
Donald_Bailey_(civil_engineer)	birthPlace	England
Horace_Lamb	birthPlace	England
Edward_Zwick	birthPlace	Illinois
Doug_Ellis	birthPlace	England
Ernest_Barnes	deathPlace	Sussex
Bridget_St_John	birthPlace	Surrey
James_Drake	deathPlace	Queensland
John_Lasseter	birthPlace	Hollywood
H._B._Warner	birthPlace	England
Cyril_Norman_Hinshelwood	birthPlace	London
Arthur_Harden	birthPlace	Manchester
Christopher_Wordsworth_(Trinity)	birthPlace	England
William_Spencer_(poet)	birthPlace	England
America_Ferrera	almaMater	University_of_Southern_California
Jon_Huntsman,_Jr.	birthPlace	California
Terri_Nunn	birthPlace	California
Frank_Thornton	deathPlace	England
Kate_Thornton	occupation	Journalist
Martin_C._Jischke	birthPlace	Illinois
James_Lofton	birthPlace	California
Joe_Principe	birthPlace	Illinois
Lynda_Bird_Johnson_Robb	birthPlace	Washington,_D.C.
Mandingo_(film)	starring	Susan_George_(actress)
Graham_Stark	birthPlace	Wallasey
Corin_Redgrave	birthPlace	London
Steve_Coleman	occupation	Composer
Sydney_Chaplin	birthPlace	England
Yvette_Mimieux	birthPlace	California
Fern_Britton	birthPlace	Middlesex
Lisa_Marx	hometown	California
Lloyd_Gough	deathPlace	California
James_McCulloch	deathPlace	United_Kingdom_of_Great_Britain_and_Ireland
Joseph_Bamford	birthPlace	England
Dino-Riders	starring	Charlie_Adler
Emil_Petaja	genre	Science_fiction
Stan_Pearson	birthPlace	England
Norrie_Paramor	birthPlace	England
Fred_Korematsu	birthPlace	California
James_Franco	almaMater	Yale_University
William_Edward_Ayrton	birthPlace	London
Saeed_Jaffrey	deathPlace	England
Mishal_Husain	occupation	Journalist
Hugh_Lloyd	birthPlace	England
Hugh_Lloyd	deathPlace	Sussex
Gail_Davis	almaMater	University_of_Texas_at_Austin
Iwao_Takamoto	occupation	Film_director
Tim_Hunt	birthPlace	Neston
Edward_Bunker	deathPlace	Burbank,_California
Jeannie_(TV_series)	producer	Iwao_Takamoto
Lassie_(1954_TV_series)	starring	Pamelyn_Ferdin
Ruth_Hanna_McCormick	birthPlace	Ohio
Henry_Cockburn_(footballer)	birthPlace	England
Jack_Elliott_(composer)	deathPlace	California
Mark_Robson	occupation	Film_director
David_Hope,_Baron_Hope_of_Craighead	almaMater	University_of_Edinburgh
Leonard_Katzman	occupation	Television_producer
Rob_Wilson	birthPlace	England
John_Mackey_(businessman)	birthPlace	Texas
Robert_Rietti	birthPlace	England
Clifford_M._Hardin	birthPlace	Indiana
Encantadia	starring	Iza_Calzado
Mark_Lancaster	almaMater	University_of_Buckingham
William_Goyen	occupation	Poet
Daniel_Levy_(businessman)	birthPlace	England
Tom_Scott_(musician)	hometown	California
Paul_Bravo	birthPlace	Campbell,_California
Paul_Bravo	birthPlace	California
Reggie_Yates	birthPlace	England
Babe_Dye	deathPlace	Illinois
Betsey_Wright	birthPlace	Texas
Betsey_Wright	occupation	Activism
Twinkle_(singer)	deathPlace	England
Lisa_Ling	birthPlace	Sacramento,_California
Wallace_Ford	deathPlace	Woodland_Hills,_Los_Angeles
Billy_Bletcher	deathPlace	California
Stanley_Rous	deathPlace	Paddington
Charles_Dance	occupation	Screenwriter
Jerome_Cowan	deathPlace	California
Homer_Thornberry	birthPlace	Austin,_Texas
Don_Pullen	associatedMusicalArtist	David_Murray_(saxophonist)
Larry_Semon	deathPlace	Victorville,_California
Thorley_Walters	birthPlace	England
Howard_Kendall	birthPlace	England
William_A._Wellman	occupation	Film_director
Henry_Jaglom	occupation	Playwright
Ted_Geoghegan	genre	Science_fiction
Fantastic_Max	producer	Mike_Young_(producer)
Chad_Everett	almaMater	Wayne_State_University
Frank_O._Salisbury	deathPlace	London
Herb_Edelman	deathPlace	California
Angel_Locsin	occupation	Model_(people)
Angel_Locsin	occupation	Film_producer
David_Li	birthPlace	England
Alan_Wheatley	deathPlace	London
Cameron_Cobbold,_1st_Baron_Cobbold	birthPlace	England
Eli_Lilly_(industrialist)	deathPlace	Indianapolis
Animorphs_(TV_series)	starring	Brooke_Nevin
Camille_Guaty	birthPlace	California
Lee_Latchford-Evans	birthPlace	England
Duke_(musician)	hometown	England
Keith_Pyott	country	England
Scout_Niblett	associatedBand	Jason_Molina
Tommy_Miller	birthPlace	England
Brian_Oulton	deathPlace	England
Tim_O'Connor_(actor)	birthPlace	Illinois
Paul_Stewart_(actor)	birthPlace	Manhattan
Colin_Blakemore	almaMater	University_of_California,_Berkeley
Brian_James_Freeman	genre	Horror_fiction
Bernie_Nolan	deathPlace	Surrey
John_Asher	occupation	Film_director
Ben_Shephard	birthPlace	Essex
A_Step_into_the_Past	starring	Kwong_Wa
A_Step_into_the_Past	producer	Chong_Wai-kin
Robert_Warwick	deathPlace	California
James_R._Keene	deathPlace	New_York_City
Graham_Branch	birthPlace	Liverpool
Michael_Elphick	deathPlace	England
Paterson_Joseph	birthPlace	England
John_B._T._Campbell_III	birthPlace	California
Wilf_Copping	birthPlace	England
Glynn_Hurst	birthPlace	England
Joe_R._Lansdale	genre	Western_fiction
London_Posse	associatedBand	Stevie_Hyper_D
Vinessa_Shaw	birthPlace	California
Faith_Brook	deathPlace	England
Richard_Webb_(actor)	deathPlace	California
Emma_Kennedy	birthPlace	England
Dick_Jauron	birthPlace	Peoria,_Illinois
Rosalind_Ayres	birthPlace	Birmingham
Rosalind_Ayres	birthPlace	England
Josh_Randall	birthPlace	Pacific_Grove,_California
Bruce_Kalish	birthPlace	California
Milt_Kahl	birthPlace	San_Francisco
Elsie_Carlisle	deathPlace	London
Elsie_Carlisle	deathPlace	England
Betty_Bronson	birthPlace	New_Jersey
Alice_in_Wonderland_(1999_film)	starring	Pete_Postlethwaite
Alex_Kew	birthPlace	Buckinghamshire
Ken_Charlery	birthPlace	England
William_Lorimer_(politician)	deathPlace	Illinois
Mark_Richardson_(musician)	birthPlace	England
David_Dortort	birthPlace	New_York_City
Janet_Weiss	associatedBand	Elliott_Smith
Athina_Livanos	birthPlace	England
Craig_Clevenger	genre	Transgressive_fiction
Steven_Hartley	birthPlace	West_Riding_of_Yorkshire
Alan_Lake	deathPlace	England
Porl_Thompson	occupation	Musician
Porl_Thompson	associatedMusicalArtist	Babacar_(band)
Simon_Hartog	birthPlace	London
Bill_Gilonis	associatedBand	The_Work_(band)
Chris_Funk	hometown	Indiana
Jane_Carr	birthPlace	England
Julian_Farino	birthPlace	England
Frederic_Manning	deathPlace	London
Robert_Westall	genre	Horror_fiction
The_Deadly_Affair	writer	Paul_Dehn
Jenny_Scheinman	hometown	California
Jeanne_Bates	deathPlace	Woodland_Hills,_Los_Angeles
Jimmy_Hanley	birthPlace	England
Slapstick_of_Another_Kind	starring	Pat_Morita
Pharez_Whitted	hometown	Indianapolis
Patrick_Carman	genre	Child
Vladimir_Colin	genre	Comic_book
Jonathan_Weinzapfel	birthPlace	Indiana
Ian_Hendry	deathPlace	London
Rosalind_Knight	birthPlace	England
Alice_Borchardt	deathPlace	Texas
Rawhide_(TV_series)	producer	Bernard_L._Kowalski
Rawhide_(TV_series)	producer	Charles_Marquis_Warren
John_D._Butler	almaMater	San_Diego_State_University
John_Dopyera	deathPlace	California
John_Illsley	birthPlace	England
John_Illsley	occupation	Songwriter
Patric_Knowles	birthPlace	United_Kingdom_of_Great_Britain_and_Ireland
Carol_Marsh	birthPlace	England
Morton_Betts	birthPlace	London
Johnny_Green	associatedMusicalArtist	Jack_Benny
Amasa_Cobb	birthPlace	Illinois
Craig_Chaquico	occupation	Musician
Richard_Johnson_(actor)	birthPlace	England
Albert_Ruskin_Cook	birthPlace	London
Simon_Elwes	birthPlace	Leicestershire
Keith_Michell	deathPlace	London
John_Figueroa	occupation	Presenter
2030_CE	starring	Tatiana_Maslany
Marcus_du_Sautoy	birthPlace	London
Dave_Pybus	occupation	Songwriter
Mike_Botts	birthPlace	California
The_Abominable_Snowman_(film)	starring	Peter_Cushing
David_Ayer	occupation	Film_producer
Peter_Beagrie	birthPlace	Middlesbrough
Terence_T._Evans	birthPlace	Wisconsin
Javed_Iqbal_(judge)	birthPlace	Sialkot
Javed_Iqbal_(judge)	almaMater	Government_College_University_(Lahore)
Dennis_Morgan	deathPlace	California
Ziauddin_Ahmad	birthPlace	British_Raj
Rufus_Reid	occupation	Composer
Brian_Trueman	country	England
Ronny_Jordan	occupation	Activism
John_Castle	birthPlace	Surrey
Jim_Noir	birthPlace	Greater_Manchester
Diane_Wood	birthPlace	New_Jersey
Diane_Wood	almaMater	University_of_Texas_at_Austin
Michael_Levitt	birthPlace	Pretoria
Emily_Woof	country	England
Roswell_Conspiracies:_Aliens,_Myths_and_Legends	starring	Scott_McNeil
Jeanne_DuPrau	birthPlace	San_Francisco
Jack_Ketchum	genre	Western_fiction
Roger_Greenaway	birthPlace	England
Derek_Newark	deathPlace	England
Barry_Bridges	birthPlace	Norfolk
Bill_Browder	birthPlace	Illinois
Christopher_Guard	birthPlace	London
Jennifer_Roberson	birthPlace	Kansas_City,_Missouri
Morgan_J._Freeman	birthPlace	Long_Beach,_California
Morgan_J._Freeman	hometown	Long_Beach,_California
Bad_Azz_(rapper)	hometown	Long_Beach,_California
Andrew_Jacobs,_Jr.	deathPlace	Indianapolis
Martin_Gilks	deathPlace	London
Tony_Cárdenas	birthPlace	Pacoima,_Los_Angeles
Craig_Anderson_(ice_hockey)	birthPlace	Illinois
Victor_Maddern	birthPlace	England
Beatrix_Lehmann	deathPlace	England
S-Endz	occupation	Songwriter
Mark_Clarke	associatedBand	Rainbow_(rock_band)
Charles_Henderson_(Nevada_politician)	almaMater	University_of_Michigan_Law_School
Evelyn_Robert_de_Rothschild	birthPlace	England
Anton_du_Beke	birthPlace	England
Bryan_John_Birch	birthPlace	Burton_upon_Trent
Dan_Gilroy	birthPlace	California
Elinor_Ostrom	almaMater	University_of_California,_Los_Angeles
Emma_Georgina_Rothschild	birthPlace	London
Frankie_Thomas	occupation	Film
Sandy_Kenyon	deathPlace	California
Peter_Coke	birthPlace	England
Armik	occupation	Composer
Bill_Davison	deathPlace	Santa_Barbara,_California
Dave_Greenslade	birthPlace	Surrey
Delroy_Facey	birthPlace	England
Harold_Munro_Fox	birthPlace	London
William_A._Earle	deathPlace	Illinois
Malcolm_Tomlinson	birthPlace	Isleworth
Malcolm_Tomlinson	occupation	Songwriter
Kevin_Gray_(footballer)	birthPlace	Sheffield
Akala_(rapper)	associatedMusicalArtist	Ms._Dynamite
Jeannie_Carson	country	England
Jan_Clayton	deathPlace	California
Donald_Moffat	birthPlace	Devon
Heinie_Conklin	birthPlace	San_Francisco
Joël_Champetier	genre	Science_fiction
Creighton_Hale	deathPlace	South_Pasadena,_California
Phil_May_(singer)	occupation	Musician
Jay_Smith_(footballer,_born_September_1981)	birthPlace	England
Shane_Paul	birthPlace	England
Paul_Hall_(footballer)	birthPlace	England
Charles_Butterworth_(actor)	occupation	Film
Chris_Brosnan	occupation	Writer
Hope_Summers	deathPlace	California
Brian_Trenchard-Smith	occupation	Screenwriter
Gerry_Chiniquy	deathPlace	Ventura_County,_California
Robert_Alfred_Theobald	birthPlace	San_Francisco
Zoe_Rahman	hometown	England
Simon_Wiles	birthPlace	England
Mark_Brzezicki	hometown	England
Coke_Escovedo	birthPlace	California
Coke_Escovedo	deathPlace	Montebello,_California
Charlie_Harper_(singer)	birthPlace	England
Ruth_Bryan_Owen	birthPlace	Illinois
Ken_Morrish	birthPlace	London
Paul_Harrison_(footballer)	birthPlace	Liverpool
Tom_Mather	deathPlace	England
Stuart_Giddings	birthPlace	Coventry
Candyman_(rapper)	associatedBand	Tone_Lōc
Candyman_(rapper)	associatedMusicalArtist	Tone_Lōc
Tommy_Doherty	birthPlace	England
Richard_Dooling	genre	Literary_fiction
John_Green_(author)	genre	Bildungsroman
Matthew_Ansara	birthPlace	California
Joseph_Blake_(criminal)	deathPlace	London
George_Wallace,_Baron_Wallace_of_Coslany	deathPlace	England
Lois_January	occupation	Film
William_Hinds	deathPlace	Guildford
William_Hinds	deathPlace	England
George_Allen_(U.S._politician)	almaMater	Juris_Doctor
Cliff_Sear	deathPlace	England
Mike_Brewer_(television_presenter)	birthPlace	England
Charmian_May	deathPlace	England
Seán_Barrett_(actor)	birthPlace	London
Geoffrey_Richardson_(musician)	occupation	Composer
Ellaline_Terriss	deathPlace	London
Sam_Schulman	deathPlace	California
Terminator:_The_Sarah_Connor_Chronicles	starring	Richard_T._Jones
Cherie_Priest	occupation	Writer
Zoë_Tyler	birthPlace	Birmingham
Micheline_Charest	birthPlace	London
Graham_Benstead	birthPlace	England
Tom_Riley_(actor)	birthPlace	England
Greg_Hunter	birthPlace	England
Anthea_Askey	birthPlace	London
Kenny_Pavey	birthPlace	London
George_King_(film_director)	birthPlace	London
Tony_Coe	birthPlace	England
Simon_Bailey_(priest)	deathPlace	West_Yorkshire
Henry_Everard	birthPlace	Chipping_Barnet
Michael_Zinberg	almaMater	University_of_Texas_at_Austin
Steve_Edge	genre	Sitcom
Robert_Done	birthPlace	England
Robert_Done	deathPlace	England
Sue_Smith_(footballer)	birthPlace	England
Plunder_&_Lightning	starring	Jim_Cummings
Graham_Fenton	birthPlace	England
Mike_Smith_(Dave_Clark_Five)	deathPlace	Buckinghamshire
Edward_LeSaint	birthPlace	Cincinnati
Oliver_Penrose	birthPlace	London
John_Pilfold	birthPlace	Sussex
Henry_William_Bayntun	deathPlace	Bath,_Somerset
William_Henry_Perkin,_Jr.	deathPlace	England
Lil'_Chris	birthPlace	Suffolk
Jack_Jackson_(British_radio)	occupation	Disc_jockey
Frank_de_Kova	deathPlace	California
Dean_Riesner	occupation	Screenwriter
Shaina_Magdayao	birthPlace	Quezon_City
Ray_Cooney	birthPlace	England
Mel_Galley	deathPlace	Staffordshire
Luke_Garrard	birthPlace	Chipping_Barnet
Vincent_Cavanagh	birthPlace	England
Mark_McCammon	birthPlace	England
Surgeon_(musician)	hometown	Birmingham
Andy_Tillson	birthPlace	England
Tim_&_Bob	associatedBand	The_Game_(rapper)
Paul_Bastock	birthPlace	England
Jane_A._Restani	almaMater	University_of_California,_Berkeley
Earl_B._Hunt	birthPlace	California
Joy_Shelton	deathPlace	Surrey
Len_Quested	birthPlace	Folkestone
Grant_Williams	deathPlace	California
Stephen_Alfred_Forbes	birthPlace	Illinois
Adam_Perry_(drummer)	hometown	Leeds
Adam_Perry_(drummer)	hometown	England
Eric_Mun	birthPlace	South_Korea
Mikey_Hachey	hometown	California
Irene_Tedrow	deathPlace	Hollywood
Darren_Brown_(musician)	birthPlace	London
John_Skipp	genre	Comedy
Tristan_Gemmill	birthPlace	Royal_Tunbridge_Wells
Mark_Bender_Gerstein	almaMater	University_of_Cambridge
Mal_Peet	genre	Children's_literature
Craig_Huxley	occupation	Writer
John_Bird_(footballer,_born_1948)	birthPlace	England
Christine_Jeffs	birthPlace	New_Zealand
Glenn_Cornick	birthPlace	England
Matt_Dearborn	birthPlace	California
Frank_Campanella	deathPlace	California
Charles_Donovan	deathPlace	England
Donald_Cunnell	birthPlace	Norfolk
Rhian_Ramos	birthPlace	Philippines
Mick_Lambert	birthPlace	England
Leon_Hapgood	birthPlace	England
Ronald_Radd	birthPlace	England
James_MacLaine	deathPlace	London
Ronald_Chetwynd-Hayes	genre	Mystery_fiction
Phil_Seamen	deathPlace	London
Lee_Flynn	birthPlace	England
Radioinactive	associatedBand	Antimc
Eugene_Halliday	deathPlace	Manchester
Nick_Duffy	birthPlace	Birmingham
Bernhard_Wise	deathPlace	England
Steve_Waller	birthPlace	South_London
Meredith_Thomas	birthPlace	England
Alison_Skipworth	birthPlace	London
Greg_Laswell	hometown	California
Noreen_Evans	almaMater	California_State_University,_Sacramento
Kevin_de_León	birthPlace	California
Doug_LaMalfa	birthPlace	California
Richard_B._Shull	deathPlace	New_York_City
Dick_Pope_(cinematographer)	birthPlace	Bromley
Tommy_Bowman	deathPlace	Southampton
Sue_Ellen_Wooldridge	birthPlace	California
Mavis_Pugh	birthPlace	England
William_Edward_Phipps	birthPlace	Vincennes,_Indiana
Pendleton_Ward	genre	Science_fiction
Sophia_Churney	associatedBand	Ooberman
Roy_Hunter	birthPlace	Middlesbrough
Alfred_Lauck_Parson	birthPlace	Lucknow
Alfred_Lauck_Parson	birthPlace	India
Zak_Orth	birthPlace	Libertyville,_Illinois
Arthur_Stanley,_5th_Baron_Stanley_of_Alderley	birthPlace	London
Mike_Hurst_(producer)	occupation	Musician
Tin_Man_(miniseries)	starring	Zooey_Deschanel
August_(2008_film)	starring	Naomie_Harris
Revolutionary_Road_(film)	starring	Leonardo_DiCaprio
Big_George	birthPlace	Clapham
Tim_Whelan	deathPlace	Beverly_Hills,_California
Robert_Lee_(obstetrician)	birthPlace	Scotland
Roy_Barcroft	deathPlace	Woodland_Hills,_Los_Angeles
Stephen_Wight	birthPlace	England
Danny_Byrd	associatedBand	Cyantific
Kurt_James	birthPlace	California
Gerry_Ingram	birthPlace	England
Assault_on_a_Queen	producer	William_Goetz
Eddie_Parker_(actor)	deathPlace	California
Andrea_Riseborough	birthPlace	Newcastle_upon_Tyne
Jimmy_Ryan_(footballer,_born_1988)	birthPlace	Liverpool
Laura_Lee	birthPlace	Illinois
Bill_Ryder-Jones	hometown	England
Douglas_Lute	birthPlace	Indiana
Peter_Collins_(record_producer)	hometown	London
Peter_Collins_(record_producer)	birthPlace	London
Peter_Collins_(record_producer)	birthPlace	England
Frederick_Chapman_(footballer)	deathPlace	Nottinghamshire
Willie_Geist	birthPlace	Illinois
Neil_Campbell_(footballer)	birthPlace	England
Skream	associatedMusicalArtist	Skrillex
Mike_Cecere	birthPlace	Cheshire
Andy_Cvercko	deathPlace	Rolling_Meadows,_Illinois
Ian_Stringfellow	birthPlace	Nottingham
Stanley_Fafara	birthPlace	San_Francisco
William_Henry_Gregory	deathPlace	England
Charles_Tertius_Mander	deathPlace	Staffordshire
Delaine_Eastin	birthPlace	California
Charles_Marcus_Mander	birthPlace	England
Yogi_and_the_Invasion_of_the_Space_Bears	starring	Michael_Rye
Jack_Doughty	deathPlace	England
Webster_E._Brown	deathPlace	Illinois
John_McPhee_(footballer)	deathPlace	England
Ronald_Garvey	almaMater	University_of_Cambridge
Timothy_Drury	birthPlace	California
Leslie_Arliss	birthPlace	England
Martyn_Campbell	birthPlace	Liverpool
Mick_Speight	birthPlace	England
Scott_Rickards	birthPlace	England
Captain_Barbell_(TV_series)	starring	Angel_Aquino
Tony_Williamson	occupation	Screenwriter
Walter_Braithwaite	deathPlace	England
Steve_Butler_(footballer)	birthPlace	Birmingham
Butterscotch_(performer)	birthPlace	California
Terry_Rawlings	birthPlace	England
Mark_Turner_(footballer)	birthPlace	Bebington
Cameron_Munter	birthPlace	Contra_Costa_County,_California
Noel_M._Smith	birthPlace	California
Norman_Wilkinson_(footballer,_born_1910)	deathPlace	Stoke-on-Trent
David_Ryall	birthPlace	Sussex
Richard_Hudson_(musician)	occupation	Musician
John_O'Rourke_(footballer)	birthPlace	England
Sid_Binks	deathPlace	Sheffield
Frank_Pettingell	birthPlace	England
Peter_Hooper	deathPlace	England
Paul_Johnson_(producer)	hometown	Illinois
Bias_Boshell	occupation	Musician
Fingazz	hometown	California
Dennis_Seaton	occupation	Composer
Wayne_Bullimore	birthPlace	England
Nat_Wolff	birthPlace	California
Pat_Terry	deathPlace	Bromley
Kent_Henry	occupation	Songwriter
Suzanne_Weyn	birthPlace	Flushing,_Queens
Suzanne_Weyn	genre	Science_fiction
John_Udal	birthPlace	West_Bromwich
Lance_Comfort	birthPlace	England
Richard_Archer	hometown	Surrey
Somak_Raychaudhury	almaMater	University_of_Cambridge
Martin_Cilia	birthPlace	Essex
Fred_Kiernan	deathPlace	Southampton
Leslie_Perrins	birthPlace	Birmingham
Edward_Blakeney	birthPlace	England
Isobel_Elsom	birthPlace	England
Michael_Ponsor	almaMater	University_of_Oxford
Tinchy_Stryder	associatedBand	Chip_(rapper)
Jamie_Robertson	hometown	England
Jack_Kirkbride	birthPlace	England
Brent_Kutzle	occupation	Musician
Martyn_Thomas	birthPlace	England
Ian_Beck	occupation	Illustrator
Matthew_Axelson	birthPlace	Cupertino,_California
Ronald_Shiner	birthPlace	London
Joe_Lynn	deathPlace	Tyne_and_Wear
David_Colquhoun	almaMater	University_of_Edinburgh
Dennis_Moore_(actor)	deathPlace	San_Bernardino,_California
Paul_Hardyman	birthPlace	Portsmouth
Arthur_Gietzelt	birthPlace	California
Alex_White_(musician)	associatedBand	The_Pipettes
Beyond_Reality_(TV_series)	starring	Shari_Belafonte
Samuel_Okikiolu	birthPlace	England
Arthur_Law_(playwright)	deathPlace	Dorset
Jock_Ewart	deathPlace	England
Michael_Quirke	birthPlace	England
Thomas_William_Bird	occupation	Clergy
All_Men_Are_Brothers_(film)	writer	Ni_Kuang
Clara_Beranger	deathPlace	California
David_Schweikert	birthPlace	California
Jack_Boothway	birthPlace	England
Lost_(TV_series)	starring	L._Scott_Caldwell
John_Phillips_(actor)	deathPlace	Oswestry
Stan_Montgomery	birthPlace	England
Emma_Willis	birthPlace	England
William_Callaway	birthPlace	California
Sam_Higginbottom	birthPlace	England
David_Weber	birthPlace	Cleveland
Ralph_Ince	occupation	Screenwriter
Earl_Zindars	occupation	Composer
John_Humphrey_(footballer)	birthPlace	England
Karen_Miller	birthPlace	Vancouver
Tony_Dobson	birthPlace	England
Gary_King_(footballer)	birthPlace	England
Bernard_Newman_(author)	birthPlace	Leicestershire
Adam_Rudolph	birthPlace	Illinois
Harold_Baily_Dixon	birthPlace	England
Ed_Earl_Repp	genre	Western_fiction
Steve_Goulding	birthPlace	England
Sam_McMahon	birthPlace	England
Frank_Bourne	birthPlace	England
Grant_Clarke	occupation	Songwriter
Elias_Porter	deathPlace	California
Duane_Roland	occupation	Musician
Norm_Ferguson_(animator)	birthPlace	New_York_City
Rob_Kardashian	birthPlace	California
Michael_Richard_Plowman	birthPlace	England
Mark_Carter_(footballer)	birthPlace	Liverpool
Heinz_A._Lowenstam	almaMater	University_of_Chicago
Mark_Mueller	occupation	Lyricist
Eskimo_(DJ)	occupation	Disc_jockey
Cruz_Martínez	occupation	Songwriter
Richard_J._Puddephatt	birthPlace	England
Fred_Wallbanks	birthPlace	England
Coleridge_and_opium	birthPlace	England
Stan_Rickaby	birthPlace	England
Anne_Dacre,_Countess_of_Arundel	deathPlace	Shifnal
Chris_Sharrock	hometown	Bebington
Chris_Sharrock	birthPlace	England
Marie_Lohr	deathPlace	Sussex
Oren_Koules	birthPlace	Illinois
Lorenzo_Smith	birthPlace	California
Guy_Liddell	deathPlace	London
Sloan_Nibley	deathPlace	California
Shaun_Pendleton	birthPlace	England
Graeme_Crallan	associatedBand	Tank_(band)
Fay_Holden	birthPlace	England
Gordon_McKeag	birthPlace	England
Bradley_Sands	genre	Absurdist_fiction
Chris_Bradford	occupation	Author
Irma_Elsa_Gonzalez	birthPlace	Palo_Alto,_California
Tommy_Farrell	birthPlace	California
Tommy_Farrell	deathPlace	Woodland_Hills,_Los_Angeles
Augustus_De_Morgan	almaMater	University_of_Cambridge
Robert_Sharples	deathPlace	England
Paul_Richards_(actor)	deathPlace	California
The_Quatermass_Experiment_(film)	starring	Jason_Flemyng
Hazel_Keech	occupation	Model_(people)
Ian_Nelson_(musician)	hometown	Wakefield
Ian_Nelson_(musician)	associatedBand	Be-Bop_Deluxe
Kirsopp_Lake	birthPlace	Southampton
Luna_Mystika	starring	Mark_Anthony_Fernandez
Princess_Maria_Carolina_of_Bourbon-Two_Sicilies_(1822–1869)	deathPlace	London
Jami_Miscik	birthPlace	Illinois
George_Jenkins_(soccer)	deathPlace	Glasgow
Kierston_Wareing	birthPlace	England
Justin_P._Wilson	almaMater	Stanford_University
Wilf_Woodcock	deathPlace	England
George_Edwin_Ellison	birthPlace	Leeds
Gareth_Evans_(footballer,_born_1967)	birthPlace	England
Deep_Voices	hometown	California
Deep_Voices	occupation	Disc_jockey
Dave_Lamb	birthPlace	London
Robert_W._Bower	birthPlace	California
Fred_Glover_(ice_hockey)	deathPlace	California
Paul_Rodgers_(footballer)	birthPlace	London
Owen_Jones_(footballer)	deathPlace	England
Geoffrey_Williams	hometown	England
Jared_Emerson-Johnson	hometown	San_Francisco
Leila_Kasra	deathPlace	California
Leila_Kasra	occupation	Lyricist
FlashForward	starring	Brían_F._O'Byrne
Michael_Brown_(footballer,_born_1984)	birthPlace	Newcastle_upon_Tyne
John_Vivyan	deathPlace	Los_Angeles_County,_California
Robert_F._Kennedy	almaMater	University_of_Virginia
Ana_Kasparian	almaMater	California_State_University,_Northridge
Pat_Conway	deathPlace	Santa_Barbara_County,_California
John_Montagu_Douglas_Scott,_7th_Duke_of_Buccleuch	birthPlace	England
Peter_Washington	birthPlace	California
De_Peyster_Brown	deathPlace	Santa_Barbara_County,_California
Sam_Jennings	birthPlace	Nottinghamshire
Hermann_Lieb	birthPlace	Switzerland
Chase_A._Clark	battle	World_War_I
Ferdinand_Francis_Fernandez	almaMater	Juris_Doctor
Anthony_W._Ishii	almaMater	UC_Berkeley_School_of_Law
Joseph_Sheard	birthPlace	England
Nancy_Juvonen	birthPlace	Marin_County,_California
Tom_Fern	deathPlace	England
Fearne_Cotton	birthPlace	London
William_Gooderham,_Sr.	birthPlace	England
Marvin_Humes	birthPlace	London
Dorothea_Holt_Redmond	deathPlace	California
George_Mason_I	birthPlace	England
Armour_Ashe	birthPlace	Paisley
Glenn_Aitken_(footballer)	birthPlace	England
Sharon_Carter_Rogers	genre	Horror_fiction
Joel_Rosenberg_(science_fiction_author)	genre	Mystery_fiction
David_Hutton_(footballer,_born_1989)	birthPlace	London_Borough_of_Enfield
John_Faulkner_(footballer)	birthPlace	England
Ted_Birnie	birthPlace	Sunderland,_Tyne_and_Wear
Ijah_Anderson	birthPlace	England
Stuart_Shaw	birthPlace	Liverpool
Frank_Rydzewski	deathPlace	Illinois
Jack_Price_(footballer,_born_1918)	deathPlace	England
Trevor_Franklin_(soccer)	birthPlace	England
Neal_S._Wolin	birthPlace	Illinois
Antony_Stretton	almaMater	University_of_Cambridge
Rosemary_Murray	birthPlace	Havant
Linden_Chiles	deathPlace	California
Ian_Crawford_(footballer)	deathPlace	Peterborough
40_Glocc	hometown	California
40_Glocc	associatedMusicalArtist	Jayo_Felony
Bashir_Syed	almaMater	University_of_Texas_at_Austin
F._Hugh_Herbert	deathPlace	Beverly_Hills,_California
Harry_Fearnley_(footballer,_born_1923)	birthPlace	England
Anton_Peterlin_(soccer)	birthPlace	San_Francisco
Norman_Moore_(footballer)	deathPlace	England
Judith_Hill	associatedMusicalArtist	Josh_Groban
Jay_Walder	birthPlace	Indiana
James_Richardson-Brown	birthPlace	England
Les_Green	birthPlace	England
Daniel_Poole	birthPlace	Cheshire
Jonathan_Harvey_(playwright)	occupation	Playwright
Tommy_Gardner	deathPlace	England
Eric_Friedman	hometown	Anaheim,_California
Stephen_James_(model)	birthPlace	England
Jack_Mustard	birthPlace	England
Fred_Molyneux	birthPlace	England
Nicholas_Phipps	birthPlace	England
John_Prendergast_(activist)	birthPlace	Indianapolis
Ernest_Wallace	deathPlace	Texas
Ernest_Foot	deathPlace	England
Roger_Hay	battle	Western_Front_(World_War_I)
Riese:_Kingdom_Falling	starring	Alessandro_Juliani
Gary_Fitzpatrick	birthPlace	England
Eleanor_Beauchamp,_Duchess_of_Somerset	birthPlace	England
Leonard_Coombes_Hammond	deathPlace	San_Francisco
Harry_Maskrey	birthPlace	Dronfield
Patrick_Gilmore_(actor)	birthPlace	Edmonton
Billy_Cook_(footballer,_born_1909)	birthPlace	Ireland
William_Gurdon_Stirling	deathPlace	England
Plastic_Crimewave	birthPlace	Illinois
Jme_(MC)	associatedMusicalArtist	Jammer_(MC)
Max_Simon_Ehrlich	birthPlace	Springfield,_Massachusetts
Volney_V._Ashford	deathPlace	California
Swadesh_Bose	deathPlace	Dhaka
Franz_W._Seidler	birthPlace	Czechoslovakia
Lori_Lindsey	birthPlace	Indianapolis
Harold_Andrews_(footballer,_born_1897)	birthPlace	England
Joe_Blochel	birthPlace	England
William_Nack	occupation	Author
Harry_Bell_(footballer,_born_1924)	deathPlace	Newcastle_upon_Tyne
Charles_Marquis_Warren	occupation	Film
Jimmy_Dudley_(footballer)	deathPlace	England
Bonnie_Lee	deathPlace	Illinois
Finn_Jones	birthPlace	England
Harry_Hurwitz	occupation	Film_producer
Amélie_of_Orléans	birthPlace	England
Otis_Leavill	birthPlace	Georgia_(U.S._state)
Jack_Souther	almaMater	Princeton_University
Roderick_Gordon	genre	Lost_World_(genre)
Brian_Cosgrove	occupation	Film_producer
Tony_Henderson	birthPlace	Newcastle_upon_Tyne
Richard_C._Miller	almaMater	University_of_Southern_California
List_of_Playboy_Playmates_of_2009	birthPlace	New_Jersey
List_of_Playboy_Playmates_of_2009	birthPlace	Fountain_Valley,_California
Sadik_Ahmed	hometown	London
Louie_Spence	birthPlace	London_Borough_of_Enfield
Henry_Thomas_Mackenzie_Bell	genre	Non-fiction
Chilly_Chill	associatedBand	Ice_Cube
Chilly_Chill	associatedMusicalArtist	Ice_Cube
List_of_Playboy_Playmates_of_1970	birthPlace	Texas
List_of_Playboy_Playmates_of_1968	birthPlace	Toledo,_Ohio
List_of_Playboy_Playmates_of_1987	birthPlace	Spokane,_Washington
List_of_Playboy_Playmates_of_1990	birthPlace	Texas
Patricia_Plunkett	deathPlace	England
Karl_McCartney	birthPlace	Birkenhead
Beastmaster_III:_The_Eye_of_Braxus	starring	Marc_Singer
Emerson_Etem	birthPlace	California
Jordan_Romero	birthPlace	California
Rod_Fletcher	birthPlace	England
George_C._Butte	almaMater	University_of_Texas_at_Austin
Scott_Ward	birthPlace	London
Leonard_Penn	birthPlace	Springfield,_Massachusetts
Leon_Isserlis	almaMater	University_College_London
Tommy_Butler_(footballer)	deathPlace	Greater_Manchester
Liam_Garrigan	birthPlace	Kingston_upon_Hull
Adam_Neder	birthPlace	Germany
George_Skinner	birthPlace	England
Peter_Ronald	birthPlace	England
Labrinth	associatedMusicalArtist	Devlin_(rapper)
Jimmy_Jones_(footballer,_born_1927)	birthPlace	England
Frank_Hoddinott	deathPlace	England
Leroy_Chambers	birthPlace	Sheffield
Adrian_Spies	deathPlace	California
Tre_Jean-Marie	birthPlace	London
Frederick_Wimble	birthPlace	England
Joseph_García_(U.S._politician)	almaMater	Harvard_Law_School
Jimmy_Bilsbury	birthPlace	Liverpool
Jack_Livesey	deathPlace	Burbank,_California
Christopher_Hacon	birthPlace	Manchester
Ron_Howell_(footballer)	birthPlace	England
Len_Julians	deathPlace	England
Wolfgang_Gartner	birthPlace	California
Nialle_Rodney	birthPlace	England
Michael_Nightingale	birthPlace	England
Yasmin_(musician)	associatedBand	Devlin_(rapper)
Anthony_A._Hyman	almaMater	University_of_Cambridge
David_Valadao	birthPlace	Hanford,_California
Baths_(musician)	hometown	California
Colin_Bucksey	birthPlace	England
Ramit_Sethi	almaMater	Stanford_University
Schoolboy_Q	birthPlace	Germany
Melanie_Scrofano	occupation	Model_(people)
Martin_Pike_(English_footballer)	birthPlace	England
Kamil_Çörekçi	birthPlace	England
Nikola_Rachelle	birthPlace	London
Ian_McCaldon	birthPlace	England
John_C._Raven	almaMater	University_of_London
Charles_G._Clarke	deathPlace	California
Fred_Nidd	deathPlace	England
Don_Smoothey	birthPlace	Fulham
Ralph_Moor	birthPlace	England
L._M._Milne-Thomson	birthPlace	London
Dick_Sawle	birthPlace	England
DJ_Cobra	occupation	Disc_jockey
Ty_Dolla_Sign	associatedBand	DJ_Mustard
Peter_Miles_(record_producer)	birthPlace	England
Owen_Simpson	birthPlace	England
Boris_Lushniak	birthPlace	Illinois
Freddie_Fox_(actor)	birthPlace	London
Richard_Janssen	birthPlace	Manchester
Richard_Janssen	birthPlace	England
GoonRock	birthPlace	Princeton,_New_Jersey
Olaus_Henrici	almaMater	Heidelberg_University
Paul_Bragiel	birthPlace	Illinois
Steven_Gaughan	birthPlace	England
Rekha_Waheed	birthPlace	London
Rekha_Waheed	almaMater	SOAS,_University_of_London
Bill_Blythe	birthPlace	Texas
Bill_Blythe	almaMater	University_of_Virginia
Shizzio	associatedBand	Devlin_(rapper)
Frederick_D._Sulcer	almaMater	University_of_Chicago
Joseph_Sgro	almaMater	University_of_California,_Los_Angeles
James_Needs	birthPlace	England
Raymond_Woodard_Brink	deathPlace	California
Terry_Shanahan	birthPlace	England
Jessica_Raine	birthPlace	Herefordshire
Elma_Yerburgh	hometown	Blackburn
Ari_Berk	birthPlace	California
Natalie_McCool	hometown	Cheshire
James_B._Clark_(director)	deathPlace	Woodland_Hills,_Los_Angeles
Paul_Priddy	birthPlace	Isleworth
Edwin_Edward_Hunnisett	birthPlace	Newhaven,_East_Sussex
Ashley_Wallbridge	recordLabel	Gareth_Emery
Erkki_Toivanen	deathPlace	London
A_Fairly_Odd_Christmas	starring	Teryl_Rothery
James_Lloyd_Findlay	battle	World_War_I
Bertram_Cohler	deathPlace	Illinois
Basil_Briggs	deathPlace	Adelaide
Günther_Krampf	deathPlace	London
Günther_Krampf	deathPlace	England
Sue_Ellspermann	almaMater	Purdue_University
Ellen_Rosenblum	almaMater	University_of_Oregon
SJ_Esau	birthPlace	England
Edward_J._Lakso	deathPlace	Beverly_Hills,_California
Controller_7	occupation	Disc_jockey
Tom_Wilson_(footballer,_born_1902)	birthPlace	England
Richard_Teale	birthPlace	Millom
Beautiful_Creatures_(2013_film)	starring	Zoey_Deutch
Eugene_Gano_Hay	birthPlace	Indiana
Maxsta	birthPlace	England
Victor_Vu	occupation	Film_producer
Kishon_Khan	birthPlace	Bangladesh
Arlen_F._Gregorio	birthPlace	California
Simon_Kassianides	birthPlace	London
Karl_Singporewala	birthPlace	England
Everett_Greenbaum	birthPlace	Buffalo,_New_York
Jeremiah_Jae	associatedMusicalArtist	Flying_Lotus
Thundercat_(musician)	associatedBand	Flying_Lotus
Thundercat_(musician)	associatedMusicalArtist	Flying_Lotus
Gordon_McClymont	deathPlace	New_South_Wales
John_B._Chitamber	almaMater	Cornell_University
Danyel_Smith	birthPlace	California
PW_(rapper)	associatedBand	Dappy
Doug_Timm	birthPlace	Illinois
Billy_Boardman	deathPlace	England
Dennis_Ayling	birthPlace	Finchley
Terry_Robbins_(footballer)	birthPlace	England
The_Originals_(TV_series)	starring	Leah_Pipes
Murder_of_Brandon_Brown	birthPlace	California
Main_Attrakionz	associatedBand	Jel
Bernard_Parker_Haigh	deathPlace	London
The_Tomorrow_People_(U.S._TV_series)	starring	Peyton_List_(actress,_born_1986)
S.K.I.T.Z_Beatz	associatedMusicalArtist	Ghetts
Richard_Fryer_(cinematographer)	deathPlace	Washington,_D.C.
Matthew_Marvin,_Sr.	birthPlace	Great_Bentley
Matthew_Marvin,_Sr.	birthPlace	England
John_Gregory_(settler)	birthPlace	Nottinghamshire
Penny_Dreadful_(TV_series)	starring	Billie_Piper
Steve_McMahon	birthPlace	England
Frederick_Chalmers_Bourne	deathPlace	England
Geoffrey_Thompson_(businessman)	deathPlace	Blackpool
Christi_Craddick	birthPlace	Texas
Manuel_Perez_(animator)	deathPlace	California
Jim_Ranchino	almaMater	University_of_Wisconsin–Madison
Frank_Martínez_(artist)	birthPlace	California
Mary_Harris_(musician)	associatedMusicalArtist	Ambrosia_(band)
Maiday	birthPlace	Worcestershire
Peta_Bala'c	birthPlace	England
Rahn_Coleman	birthPlace	California
Jamie_Brewer	birthPlace	California
Werner_Theunissen	deathPlace	England
From_Dusk_till_Dawn:_The_Series	starring	Esai_Morales
Drew_Darby	almaMater	University_of_Virginia
Charles_Layard	deathPlace	England
Erin_Beck	birthPlace	California
The_After	starring	Jamie_Kennedy
Anne_Barton	almaMater	University_of_Cambridge
Brandon_Creighton	birthPlace	Texas
Ben_Gladwin	birthPlace	England
John_Jessop	birthPlace	England
Paul_Luty	birthPlace	England
Gary_Blackford	birthPlace	England
Stuart_Myall	birthPlace	Eastbourne
Ryat	recordLabel	Brainfeeder
Richard_W._Goode	birthPlace	London
Karl_Hajos	occupation	Composer
Rube_Brandow	deathPlace	California
Jamie_England	birthPlace	England
Susan_King_(Texas_politician)	almaMater	University_of_Texas_at_Austin
Bennett_Ratliff	almaMater	University_of_Texas_at_Austin
C._Arnold_Beevers	birthPlace	England
Ray_Keith	birthPlace	Essex
Jordan_Fowler	birthPlace	England
Matthias_Sention,_Jr.	birthPlace	Berkshire
Antoni_Janusz	birthPlace	Poland
Alec_Sundly	birthPlace	California
J._Ellis_Rodley	deathPlace	California
Louis_H._Bruni	almaMater	University_of_Texas_at_Austin
Lindsley_Parsons	deathPlace	California
Jason_Evigan	birthPlace	California
Stephen_Jackson_(scientist)	almaMater	University_of_Leeds
Harold_Rothery_Nutt	deathPlace	England
Roy_Cotton	birthPlace	England
Jackie_Foster	birthPlace	England
Caroline_Howard_Hume	deathPlace	California
Emmet_Wan	birthPlace	England
George_Parsonage	birthPlace	England
Hughie_Reed	birthPlace	Scotland
Patrick_Villiers_Farrow	deathPlace	California
John_Darrow	deathPlace	California
Vicki_L._Hanson	almaMater	University_of_Oregon
George_Pajon	associatedMusicalArtist	Bucky_Jonson
Robert_Kurrle	deathPlace	California
Stephen_Simpson_(doctor)	deathPlace	England
William_Collins_Engledue	birthPlace	England
John_W._Boyle	deathPlace	Hollywood
Sonia_Yasmin_Ali	birthPlace	England
Dean_Williams_(footballer,_born_1970)	birthPlace	England
Ice_(2011_miniseries)	starring	Frances_O'Connor
Ethel_Hill	deathPlace	Hollywood
Cliff_Myers	birthPlace	England
Michael_Aylesworth	birthPlace	Indiana
Emma_Richler	birthPlace	England
Brian_Mundee	birthPlace	England
Sydney_Davis_(politician)	birthPlace	Dorset
Alfredo_Kanthack	birthPlace	Brazil
Lister_Laurance	deathPlace	London
Kieran_Wallace	birthPlace	England
Kathleen_M._Sutcliffe	almaMater	University_of_Texas_at_Austin
John_Tyrel	deathPlace	Queensland
Julian_Rivero	deathPlace	California
Sarah_Begum	occupation	Journalist
Timothy_F._Jamison	almaMater	Harvard_University
Mike_Epps	birthPlace	Indiana
Mike_Epps	genre	Satire
Ransley_Thacker	birthPlace	England
Darryl_Yokley	birthPlace	California
Helen_DeMacque	birthPlace	London
Tiff_Joy	hometown	Illinois
John_Givez	occupation	Songwriter
John_Givez	associatedMusicalArtist	JGivens
Christel_Lee	birthPlace	Bloomington,_Indiana
Derek_Wax	birthPlace	England
Toronzo_Cannon	birthPlace	Illinois
Arthur_Jones_(Australian_politician)	deathPlace	Queensland
